一	一ＹＩ
丁	丁ＤＧ
七	七ＱＩ
万	丆亅Ｗ
万	丆亅Ｍ
丈	丈ＺＧ
三	三ＳＮ
上	卜一Ｓ
下	下ＸＡ
不	不ＢＵ
与	与ＹＵ
丐	一卜Ｓ
丑	丑ＣＵ
专	二龴Ｚ
且	且ＱＥ
丕	不一Ｐ
世	世ＳＩ
丘	丘ＱＵ
丙	一内Ｂ
业	业ＹＥ
丛	人人一
东	七小Ｄ
丝	丝丝一
丞	乛水一
丢	千一厶
两	两ＬＧ
严	亚丿Ｙ
丧	十首ｒ
个	人丨Ｇ
丫	丷丨Ｙ
中	口丨Ｚ
丰	丰ＦＧ
串	口口丨
临	刂Ｋ日
丸	九丶Ｗ
丹	冂亠Ｄ
为	冫力Ｗ
主	主ＺＵ
丽	一冂冂
举	兴八干
乃	乃ＮＩ
久	刀丶Ｊ
么	丿厶Ｍ
义	丶乂Ｙ
之	之ＺＩ
乌	乌ＷＵ
乍	乍ＺＡ
乎	丿丷丁
乏	丿之Ｆ
乐	Ｃ小Ｌ
乐	Ｃ小Ｙ
乒	丘丿Ｐ
乓	丘丶Ｐ
乔	丿大刂
乖	千丬匕
乘	禾丬匕
乙	乙ＹＩ
乜	亅乚Ｍ
乜	亅乚Ｎ
九	九ＪＵ
乞	人乙Ｑ
也	也ＹＥ
习	习ＸＩ
乡	丝丿Ｘ
书	乛卩丶
乩	占占乚
买	乛头Ｍ
乱	舌乚Ｌ
乳	爫子乚
乾	十十乙
了	乛亅Ｌ
予	龴丁Ｙ
争	刀彐亅
事	丁口彐
二	二ＥＲ
亍	亍ＣＵ
于	于ＹＵ
亏	二ＳＫ
云	云ＹＮ
互	一彑Ｈ
亓	二刂Ｑ
五	五ＷＵ
井	井ＪＧ
亘	一日一
亚	亚ＹＡ
些	止匕二
亟	乛亅一
亡	亡ＷＧ
亢	亠几Ｋ
交	亠父Ｊ
亥	亥ＨＩ
亦	亦ＹＩ
产	立丿Ｃ
亨	高乛亅
亩	亠田Ｍ
享	高子Ｘ
京	高小Ｊ
亭	亮丁Ｔ
亮	亮几Ｌ
亲	亲ＱＮ
亲	亲ＱＧ
亳	亮丿七
亵	衣执执
人	人ＲＮ
亿	亻乙Ｙ
什	亻十Ｓ
仁	亻二Ｒ
仂	亻力Ｌ
仃	亻丁Ｄ
仄	厂人Ｚ
仅	亻又Ｊ
仆	亻卜Ｐ
仇	亻九Ｃ
仇	亻九Ｑ
仉	亻几Ｚ
今	亽乛Ｊ
介	人刂Ｊ
仍	亻乃Ｒ
从	人人Ｃ
仑	人匕Ｌ
仓	仓ＣＧ
仔	亻子Ｚ
仕	亻士Ｓ
他	亻也Ｔ
仗	亻丈Ｚ
付	亻寸Ｆ
仙	亻山Ｘ
仝	人工Ｔ
仞	亻刀丶
仟	亻千Ｑ
仡	亻人乙
代	代ＤＩ
令	亽龴Ｌ
以	以ＹＩ
仨	亻三Ｓ
仪	亻丶乂
仫	亻丿厶
们	亻门Ｍ
仰	亻Ｃ卩
仲	亻口丨
仳	亻比Ｐ
仵	亻午Ｗ
件	亻牛Ｊ
价	亻人刂
任	亻壬Ｒ
份	亻分Ｆ
仿	亻方Ｆ
企	人止Ｑ
伉	亻亠几
伊	亻彐丿
伍	亻五Ｗ
伎	亻十又
伏	亻大丶
伐	亻戈Ｆ
休	亻木Ｘ
众	人人人
优	亻尢丶
伙	亻火Ｈ
会	人云Ｈ
会	人云Ｋ
伛	亻匚乂
伞	人丷十
伟	亻二卩
传	亻二龴
伢	亻一才
伤	亻人力
伥	亻长Ｃ
伦	亻人匕
伧	亻仓Ｃ
伪	亻冫力
伫	亻宀一
伯	亻白Ｂ
估	亻古Ｇ
伲	亻尸匕
伴	亻半Ｂ
伶	亻亽龴
伸	亻日丨
伺	亻亅一
似	亻以Ｓ
伽	亻加Ｊ
伽	亻加Ｇ
伽	亻加Ｑ
佃	亻田Ｄ
但	亻日一
位	亻立Ｗ
低	亻Ｃ七
住	亻主Ｚ
佐	亻厂工
佑	亻厂口
体	亻木一
何	亻可Ｈ
佗	亻宀匕
佘	人示Ｓ
余	余ＹＵ
佚	亻失Ｙ
佛	亻弓刂
作	亻乍Ｚ
佝	亻勹口
佞	亻二女
佟	亻夂冫
你	亻刀小
佣	亻用Ｙ
佤	亻瓦Ｗ
佥	亼兴Ｑ
佩	亻几一
佬	亻耂匕
佯	亻羊Ｙ
佰	亻丆日
佳	亻圭Ｊ
佴	亻耳Ｎ
佶	亻吉Ｊ
佻	亻ＫＫ
佼	亻亠父
佾	亻八冃
使	亻丈口
侃	亻口川
侄	亻一土
侈	亻夕夕
侉	亻大Ｓ
例	亻歹刂
侍	亻土寸
侏	亻朱Ｚ
侑	亻厂冃
侔	亻厶牛
侗	亻冂一
供	亻龷八
依	亻衣Ｙ
侠	亻夫丷
侣	亻口口
侥	亻戈儿
侦	亻卜贝
侧	亻贝刂
侨	亻丿刂
侩	亻人云
侪	亻文刂
侬	亻巾ｒ
侮	亻人母
侯	亻尸矢
侵	亻彐又
便	亻丈日
促	亻足Ｃ
俄	亻手戈
俅	亻氺丶
俊	亻厶夂
俎	人人且
俏	亻Ｍ冃
俐	亻禾刂
俑	亻龴用
俗	亻谷Ｓ
俘	亻爫子
俚	亻里Ｌ
俜	亻由丂
保	亻口木
俞	亼前Ｙ
俟	亻厶矢
信	亻言Ｘ
俣	亻口大
俦	亻丰寸
俨	亻亚丿
俩	亻两Ｌ
俪	亻一冂
俭	亻亼兴
修	亻夂彡
俯	亻广寸
俱	亻且八
俳	亻非Ｐ
俸	亻<春上>干
俺	亻大乚
俾	亻卑卑
倌	亻宀官
倍	亻立口
倏	亻夂大
倒	亻一刂
倔	亻尸出
倘	亻尚Ｔ
候	亻尸矢
倚	亻大可
倜	亻冂土
借	亻龷日
倡	亻日日
倥	亻穴工
倦	亻龹㔾
倨	亻尸古
倩	亻青Ｑ
倪	亻臼儿
倬	亻卜十
倭	亻禾女
倮	亻日木
债	亻龶贝
值	亻十且
倾	亻匕页
偃	亻匚日
假	亻尸又
偈	亻日勹
偌	亻艹口
偎	亻田ｒ
偏	亻户冊
偕	亻比白
做	亻古攵
停	亻亮丁
健	亻彐廴
偬	亻勹心
偶	亻甲冂
偷	亻亼前
偻	亻米女
偾	亻十贝
偿	亻龸云
傀	亻白儿
傅	亻甫寸
傈	亻覀木
傍	亻旁方
傣	亻<春上>氺
傥	亻尚儿
傧	亻穴丘
储	亻讠者
傩	亻又隹
催	亻山隹
傲	亻敖Ａ
傺	亻祭示
傻	亻白夂
像	亻象Ｘ
僖	亻吉口
僚	亻大小
僦	亻尢丶
僧	亻丷日
僬	亻焦Ｊ
僭	亻旡日
僮	亻立里
僳	亻覀米
僵	亻一一
僻	亻尸辛
儆	亻艹攵
儇	亻罒ｒ
儋	亻刀言
儒	亻雨皿
儡	亻田田
儿	儿ＥＲ
兀	一儿Ｗ
允	厶儿Ｙ
元	元ＹＮ
兄	口儿Ｘ
充	充儿Ｃ
兆	ＫＫＺ
先	牛儿Ｘ
光	Ｍ一儿
克	古儿Ｋ
免	刀口儿
兑	丷口儿
兔	兔ＴＵ
兕	凹儿Ｓ
兖	亠八儿
党	尚儿Ｄ
兜	Ｃ尸儿
兢	古儿儿
入	丿丶Ｒ
全	全ＱＮ
八	八ＢＡ
公	八厶Ｇ
六	亠八Ｌ
兮	八丂Ｘ
兰	首二Ｌ
共	龷八Ｇ
关	丷大Ｇ
兴	兴八Ｘ
兵	丘八Ｂ
其	其ＱＩ
具	且八Ｊ
典	冂龷八
兹	首幺幺
养	羊丶刂
兼	首彐兼
兽	丷田口
冀	丬匕八
冁	丷十ｒ
内	内ＮＩ
冈	冂乂Ｇ
冉	冂土Ｒ
册	册ＣＥ
再	王冂Ｚ
冒	日目Ｍ
冕	日刀儿
冗	冖几Ｒ
写	冖与Ｘ
军	冖车Ｊ
农	巾ｒＮ
冠	冖元寸
冢	冖豕丶
冤	冖兔Ｙ
冥	冖日八
冬	夂冫Ｄ
冯	冫马Ｆ
冰	冫水Ｂ
冱	冫一彑
冲	冫口丨
决	冫夬Ｊ
况	冫口儿
冶	冫厶口
冷	冫亽龴
冻	冫七小
冼	冫牛儿
冽	冫歹刂
净	冫刀亅
凄	冫十女
准	冫隹Ｚ
凇	冫八厶
凉	冫高小
凋	冫冂土
凌	冫土夂
减	冫戊一
凑	冫<春上>大
凛	冫亠示
凝	冫龴止
几	几ＪＩ
凡	几丶Ｆ
凤	几又Ｆ
凫	鸟几Ｆ
凭	亻壬几
凯	山己几
凰	几白王
凳	癶一几
凶	乂凵Ｘ
凸	凸ＴＵ
凹	凹ＡＯ
出	出ＣＵ
击	干凵Ｊ
凼	水凵Ｄ
函	乛氺凵
凿	业首凵
刀	刀ＤＯ
刁	亅一Ｄ
刃	刀丶Ｒ
分	分ＦＮ
切	七刀Ｑ
刈	乂刂Ｙ
刊	干刂Ｋ
刍	刀彐Ｃ
刎	勹彳刂
刑	一廾刂
划	戈刂Ｈ
刖	月刂Ｙ
列	歹刂Ｌ
刘	文刂Ｌ
则	贝刂Ｚ
刚	冂乂刂
创	仓刂Ｃ
初	衤刀Ｃ
删	册刂Ｓ
判	半刂Ｐ
刨	包刂Ｐ
刨	包刂Ｂ
利	禾刂Ｌ
别	另刂Ｂ
刭	又工刂
刮	舌刂Ｇ
到	一土刂
刳	大Ｓ刂
制	牛冂刂
刷	尸巾刂
券	龹刀Ｑ
券	龹刀Ｘ
刹	乂朩刂
刺	木冂刂
刻	亥刂Ｋ
刽	人云刂
刿	山夕刂
剀	山己刂
剁	几木刂
剂	文刂刂
剃	丷丿刂
削	Ｍ冃刂
剌	木口刂
前	首前Ｑ
剐	口内刂
剑	亼兴刂
剔	日彳刂
剖	立口刂
剜	宀夕刂
剞	大可刂
剡	火火刂
剥	彐水刂
剧	尸古刂
剩	禾丬刂
剪	首前刀
副	畐刂Ｆ
割	宀口刂
剽	覀示刂
剿	巛木刂
劁	焦刂Ｑ
劂	厂丷刂
劈	尸辛刀
劐	艹又刂
劓	丿丌刂
力	力ＬＩ
劝	又力Ｑ
办	力八Ｂ
功	工力Ｇ
加	加ＪＡ
务	夂力Ｗ
劢	丆亅力
劣	少力Ｌ
动	云力Ｄ
助	且力Ｚ
努	女又力
劫	土厶力
劬	勹口力
劭	召力Ｓ
励	厂丆力
劲	又工力
劳	营力Ｌ
劾	亥力Ｈ
势	执执力
勃	十子力
勇	龴用力
勉	刀儿力
勋	口贝力
勐	子皿力
勒	革力Ｌ
勖	日目力
勘	其乚力
募	莫力Ｍ
勤	廿龶力
勰	力力心
勺	勹丶Ｓ
勾	勹厶Ｇ
勿	勹彳Ｗ
匀	勹冫Ｙ
包	包ＢＯ
匆	勹彳丶
匈	勹乂凵
匍	勹甫Ｐ
匏	大Ｓ包
匐	勹畐Ｆ
匕	匕ＢＩ
化	亻匕Ｈ
北	丬匕Ｂ
匙	日止匕
匝	匚巾Ｚ
匠	匚斤Ｊ
匡	匚王Ｋ
匣	匚甲Ｘ
匦	匚车九
匪	匚非Ｆ
匮	匚贵Ｋ
匹	匚儿Ｐ
区	匚乂Ｑ
区	匚乂Ｏ
医	匚矢Ｙ
匾	匚户冊
匿	匚艹厂
十	十ＳＩ
千	千ＱＮ
卅	卅ＳＡ
升	丿廾Ｓ
午	午ＷＵ
卉	十廾Ｈ
半	半ＢＮ
华	亻匕十
协	十力八
卑	卑卑Ｂ
卒	亠人十
卓	卜日十
单	丷日十
卖	十乛头
南	Ｍ首十
博	十甫寸
卜	卜ＢＵ
卜	卜ＢＯ
卞	亠卜Ｂ
卟	口卜Ｂ
占	占占Ｚ
卡	卜下Ｋ
卡	卜下Ｑ
卢	卜尸Ｌ
卣	卜囗尸
卤	卜囗乂
卦	圭卜Ｇ
卧	匚丨卜
卫	卩一Ｗ
卮	Ｆ㔾Ｚ
卯	Ｇ卩Ｍ
印	Ｅ卩Ｙ
危	刀厂㔾
即	艮卩Ｊ
却	土厶卩
卵	Ｇ冫卩
卷	龹㔾Ｊ
卸	人止卩
卺	乛水㔾
卿	Ｇ艮卩
厂	厂ＣＧ
厄	厂㔾Ｅ
厅	厂丁Ｔ
历	厂力Ｌ
厉	厂丆亅
压	厂土丶
厌	厂大丶
厍	厂车Ｓ
厕	厂贝刂
厘	厂里Ｌ
厚	厂日子
厝	厂龷日
原	厂白小
厢	厂木目
厣	厂大甲
厥	厂丷欠
厦	厂丆夂
厨	厂一寸
厩	厂艮旡
厮	厂其斤
去	土厶Ｑ
县	且厶Ｘ
叁	厶大三
参	厶大彡
又	又ＹＵ
叉	又丶Ｃ
及	及ＪＩ
友	厂又Ｙ
双	又又Ｓ
反	反反Ｆ
发	发ＦＡ
叔	卜小又
取	耳又Ｑ
受	受ＳＵ
变	亦又Ｂ
叙	余又Ｘ
叛	半反反
叟	叟ＳＵ
叠	又又且
口	口ＫＵ
古	古ＧＵ
句	勹口Ｊ
句	勹口Ｇ
另	另ＬＧ
叨	口刀Ｄ
叨	口刀Ｔ
叩	口卩Ｋ
只	口八Ｚ
叫	口丩Ｊ
召	召ＺＯ
召	召ＳＯ
叭	口八Ｂ
叮	口丁Ｄ
可	可ＫＥ
台	厶口Ｔ
叱	口匕Ｃ
史	口乂Ｓ
右	厂口Ｙ
叵	匚口Ｐ
叶	口十Ｙ
叶	口十Ｘ
号	口丂Ｈ
司	亅一口
叹	口又Ｔ
叻	口力Ｌ
叼	口亅一
叽	口几Ｊ
吁	口于Ｙ
吁	口于Ｘ
吃	口人乙
各	各ＧＥ
吆	口幺Ｙ
合	亼口Ｈ
合	亼口Ｇ
吉	吉ＪＩ
吊	口巾Ｄ
同	冂一口
名	夕口Ｍ
后	Ｆ口Ｈ
吏	丈口Ｌ
吐	口土Ｔ
向	白口Ｘ
吒	口丿七
吓	口下Ｘ
吓	口下Ｈ
吕	口口Ｌ
吖	口丷丨
吗	口马Ｍ
君	彐丿口
吝	文口Ｌ
吞	一大口
吟	口亽乛
吠	口大丶
吡	口比Ｂ
吣	口心Ｑ
否	不口Ｆ
否	不口Ｐ
吧	口巴Ｂ
吨	口七凵
吩	口分Ｆ
含	亽乛口
听	口斤Ｔ
吭	口亠几
吮	口厶儿
启	户口Ｑ
吱	口十又
吲	口弓丨
吴	口一大
吵	口少Ｃ
吸	口及Ｘ
吹	口欠Ｃ
吻	口勹彳
吼	口子乚
吾	五口Ｗ
呀	口一才
呃	口厂㔾
呆	口木Ｄ
呈	口王Ｃ
告	告ＧＯ
呋	口夫Ｆ
呐	口内Ｎ
呒	口干乚
呓	口艹乙
呔	口大丶
呕	口匚乂
呖	口厂力
呗	口贝Ｂ
员	口贝Ｙ
呙	口内Ｇ
呛	口仓Ｑ
呜	口乌Ｗ
呢	口尸匕
呤	口亽龴
呦	口幺力
周	冂土口
呱	口瓜Ｇ
呲	口止匕
味	口未Ｗ
呵	口可Ｈ
呶	口女又
呷	口甲Ｘ
呸	口不一
呻	口日丨
呼	口丿丁
命	亼口卩
咀	口且Ｊ
咀	口且Ｚ
咂	口匚巾
咄	口出Ｄ
咆	口包Ｐ
咋	口乍Ｚ
和	禾口Ｈ
咎	夂卜口
咏	口丶水
咐	口亻寸
咒	口口几
咔	口卜下
咕	口古Ｇ
咖	口加Ｋ
咖	口加Ｇ
咙	口龙Ｌ
咚	口夂冫
咛	口宁Ｎ
咝	口丝一
咣	口Ｍ儿
咤	口宀七
咦	口大弓
咧	口歹刂
咨	冫欠口
咩	口羊Ｍ
咪	口米Ｍ
咫	尺口八
咬	口亠父
咯	口各Ｋ
咯	口各Ｌ
咯	口各Ｇ
咱	口丿目
咳	口亥Ｋ
咳	口亥Ｈ
咴	口厂火
咸	戊一口
咻	口亻木
咽	口囗大
咿	口彐丿
哀	衣口Ａ
品	口口口
哂	口西Ｓ
哄	口龷八
哆	口夕夕
哇	口圭Ｗ
哈	口亼口
哉	十戈口
哌	口厂ｒ
响	口白口
哎	口艹乂
哏	口艮Ｇ
哐	口匚王
哑	口亚Ｙ
哒	口大辶
哓	口戈儿
哔	口比十
哕	口山夕
哗	口匕十
哙	口人云
哚	口几木
哝	口巾ｒ
哞	口厶牛
哟	口纟勹
哥	可可Ｇ
哦	口手戈
哧	口土亦
哨	口Ｍ冃
哩	口里Ｌ
哪	口月阝
哭	口口大
哮	口耂子
哲	扌斤口
哳	口扌斤
哺	口甫Ｂ
哼	口高亅
哽	口丈日
哿	加可Ｇ
唁	口言Ｙ
唆	口厶夂
唇	厂ｒ口
唉	口厶矢
唏	口乂巾
唐	广彐口
唑	口人土
唔	口五口
唛	口龶夂
唠	口营力
唢	口Ｍ贝
唣	口白七
唤	口刀大
唧	口艮卩
唪	口<春上>干
唬	口虍几
售	隹口Ｓ
唯	口隹Ｗ
唰	口尸刂
唱	口日日
唳	口户大
唷	口充冃
唼	口立女
唾	口千垂
唿	口勹心
啁	口冂土
啃	口止冃
啄	口豕丶
商	商ＳＧ
啉	口林Ｌ
啊	口阝可
啐	口亠十
啕	口勹缶
啖	口火火
啜	口又又
啡	口非Ｆ
啤	口卑卑
啥	口亼古
啦	口扌立
啧	口龶贝
啪	口扌白
啬	十首囗
啭	口二龴
啮	口止凵
啵	口氵皮
啶	口宀止
啷	口丶阝
啸	口彐川
啻	旁巾口
啼	口旁巾
啾	口禾火
喀	口宀各
喁	口甲冂
喂	口田ｒ
喃	口Ｍ首
善	羊首口
喇	口木刂
喈	口比白
喉	口尸矢
喊	口戊一
喋	口世木
喏	口艹口
喑	口立日
喔	口尸土
喘	口山皿
喙	口彑豕
喜	吉首口
喝	口日勹
喟	口田冃
喧	口宀一
喱	口厂里
喳	口木一
喵	口艹田
喷	口十贝
喹	口大圭
喻	口亼前
喽	口米女
喾	学告Ｋ
嗄	口丆夂
嗅	口丿大
嗉	口龶小
嗌	口首皿
嗍	口丷月
嗑	口土皿
嗒	口艹口
嗓	口又木
嗔	口十八
嗖	口叟Ｓ
嗜	口耂日
嗝	口一冂
嗟	口羊工
嗡	口八羽
嗣	口冊亅
嗤	口屮虫
嗥	口白十
嗦	口十小
嗨	口人母
嗪	口<春上>禾
嗫	口耳又
嗬	口艹可
嗯	口囗心
嗲	口父夕
嗳	口爱爱
嗵	口龴辶
嗷	口敖Ａ
嗽	口木欠
嗾	口族矢
嘀	口啇Ｄ
嘁	口戊卜
嘈	口西日
嘉	吉首加
嘌	口覀示
嘎	口丆戈
嘏	古尸又
嘘	口虍业
嘛	口广林
嘞	口革力
嘟	口者阝
嘣	口山月
嘤	口贝女
嘧	口宀山
嘬	口日又
嘭	口吉彡
嘱	口尸冂
嘲	口十月
嘴	口匕用
嘶	口其斤
嘹	口大小
嘻	口吉口
嘿	口黑Ｈ
噌	口丷日
噍	口焦Ｊ
噎	口士首
噔	口癶首
噗	口业丶
噘	口厂欠
噙	口人冂
噜	口鱼日
噢	口白大
噤	口林示
器	口口口
噩	王口口
噪	口口木
噫	口立心
噬	口竹工
噱	口虍豕
噶	口艹勹
噻	口宀土
噼	口尸辛
嚅	口雨皿
嚆	口艹高
嚎	口亮豕
嚏	口十止
嚓	口宀示
嚣	口口口
嚯	口雨隹
嚷	口衣口
嚼	口爫寸
囊	十口ｒ
囔	口十ｒ
囚	囗人Ｑ
四	囗儿Ｓ
回	囗口Ｈ
囟	白乂Ｘ
因	囗大Ｙ
囡	囗女Ｎ
团	囗才Ｔ
囤	囗七凵
囫	囗勹彳
园	囗元Ｙ
困	囗木Ｋ
囱	白夂Ｃ
围	囗二卩
囵	囗人匕
囹	囗亽龴
固	囗古Ｇ
国	囗王丶
图	囗夂冫
囿	囗厂冃
圃	囗甫Ｐ
圄	囗五口
圆	囗口贝
圈	囗龹㔾
圉	囗土首
圊	囗青Ｑ
圜	囗罒一
土	土ＴＵ
圣	又土Ｓ
在	Ｐ土Ｚ
圩	土于Ｗ
圩	土于Ｘ
圪	土人乙
圬	土二Ｓ
圭	圭ＧＩ
圮	土己Ｐ
圯	土巳Ｙ
地	土也Ｄ
圳	土川Ｚ
圹	土广Ｋ
场	土Ｊ彳
圻	土斤Ｑ
圾	土及Ｊ
址	土止Ｚ
坂	土反反
均	土勹冫
坊	土方Ｆ
坌	分土Ｂ
坍	土冂亠
坎	土欠Ｋ
坏	土不Ｈ
坐	人人土
坑	土亠几
块	土夬Ｋ
坚	刂又土
坛	土云Ｔ
坜	土厂力
坝	土贝Ｂ
坞	土乌Ｗ
坟	土文Ｆ
坠	阝人土
坡	土皮Ｐ
坤	土日丨
坦	土日一
坨	土宀匕
坩	土廿一
坪	土干丷
坫	土占占
坭	土尸匕
坯	土不一
坳	土幺力
坷	土可Ｋ
坻	土Ｃ七
坼	土斤丶
垂	千垂Ｃ
垃	土立Ｌ
垄	龙土Ｌ
垆	土卜尸
型	一刂土
垌	土冂一
垒	厶厶土
垓	土亥Ｇ
垛	土几木
垠	土艮Ｙ
垡	亻戈土
垢	土Ｆ口
垣	土一一
垤	土一土
垦	艮土Ｋ
垧	土白口
垩	亚土Ｅ
垫	执执土
垭	土亚Ｙ
垮	土大Ｓ
垲	土山己
垴	土文凵
垸	土宀元
埂	土丈日
埃	土厶矢
埋	土里Ｍ
城	土戊亅
埏	土丿廴
埒	土爫寸
埔	土甫Ｐ
埔	土甫Ｂ
埕	土口王
埘	土日寸
埙	土口贝
埚	土口内
埝	土亽心
域	土戈口
埠	土追十
埤	土卑卑
埭	土彐水
埯	土大乚
埴	土十且
埸	土日勹
培	土立口
基	其土Ｊ
埽	土彐巾
堂	尚土Ｔ
堆	土隹Ｄ
堇	廿口龶
堋	土月月
堍	土兔Ｔ
堑	车斤土
堕	阝厂土
堙	土覀土
堞	土世木
堠	土尸矢
堡	亻口土
堤	土日止
堪	土其乚
堰	土匚日
堵	土者Ｄ
塄	土罒方
塌	土日羽
塍	月龹土
塑	丷月土
塔	土艹口
塘	土广口
塞	宀井土
塥	土一冂
填	土十八
塬	土厂小
塾	高九土
墀	土尸牛
墁	土日又
境	土竟Ｊ
墅	里龴土
墉	土广冃
墒	土商Ｓ
墓	莫土Ｍ
墙	土十囗
墚	土刀木
增	土丷日
墟	土虍业
墨	黑土Ｍ
墩	土高攵
墼	車殳土
壁	尸辛土
壅	亠丝土
壑	卜又土
壕	土亮豕
壤	土衣口
士	士ＳＩ
壬	壬ＲＮ
壮	丬士Ｚ
声	声ＳＧ
壳	士冖几
壶	士冖业
壹	士冖首
处	夂卜Ｃ
备	夂田Ｂ
复	人日夂
夏	丆目夂
夔	首丿夂
夕	夕ＸＩ
外	夕卜Ｗ
夙	几歹Ｓ
多	夕夕Ｄ
夜	亠亻夂
够	勹口夕
夤	夕穴一
夥	日木夕
大	大ＤＡ
大	大ＤＩ
天	一大Ｔ
太	大丶Ｔ
夫	夫ＦＵ
夭	丿大Ｙ
央	央ＹＧ
夯	大力Ｈ
失	失ＳＩ
头	头ＴＵ
夷	大弓Ｙ
夸	大二Ｓ
夹	夫丷Ｊ
夹	夫丷Ｇ
夺	大寸Ｄ
夼	大川Ｋ
奁	大匚乂
奂	刀冂大
奄	大日乚
奇	大可Ｑ
奇	大可Ｊ
奈	大示Ｎ
奉	<春上>干Ｆ
奋	大田Ｆ
奎	大圭Ｋ
奏	<春上>一大
契	丰刀大
奔	大十廾
奕	亦大Ｙ
奖	丬夕大
套	大Ｅ厶
奘	爿士大
奚	爫幺大
奠	酋大Ｄ
奢	大者Ｓ
奥	白米大
女	女ＮＶ
奴	女又Ｎ
奶	女乃Ｎ
奸	女干Ｊ
她	女也Ｔ
好	女子Ｈ
妁	女勹丶
如	女口Ｒ
妃	女己Ｆ
妄	亡女Ｗ
妆	丬女Ｚ
妇	女彐Ｆ
妈	女马Ｍ
妊	女壬Ｒ
妍	女一廾
妒	女户Ｄ
妓	女十又
妖	女丿大
妗	女亽乛
妙	女少Ｍ
妞	女丑Ｎ
妣	女比Ｂ
妤	女龴丁
妥	爫女Ｔ
妨	女方Ｆ
妩	女干乚
妪	女匚乂
妫	女冫力
妮	女尸匕
妯	女由Ｚ
妲	女日一
妹	女未Ｍ
妻	十彐女
妾	立女Ｑ
姆	女母Ｍ
姊	女丿Ｓ
始	女厶口
姐	女且Ｊ
姑	女古Ｇ
姒	女以Ｓ
姓	女丿龶
委	禾女Ｗ
姗	女册Ｓ
姘	女首廾
姚	女ＫＫ
姜	<美上>女Ｊ
姝	女朱Ｓ
姣	女亠父
姥	女耂匕
姨	女大弓
姬	女匚丨
姹	女宀七
姻	女囗大
姿	冫欠女
威	戊一女
娃	女圭Ｗ
娄	米女Ｌ
娅	女亚Ｙ
娆	女戈儿
娇	女丿刂
娈	亦女Ｌ
娉	女由丂
娌	女里Ｌ
娑	氵少女
娓	女尸毛
娘	女丶艮
娜	女月阝
娟	女口冃
娠	女厂ｒ
娣	女丷弓
娥	女手戈
娩	女刀儿
娱	女口大
娲	女口内
娴	女门木
娶	耳又女
娼	女日日
婀	女阝可
婆	氵皮女
婉	女宀㔾
婊	女龶ｒ
婕	女一止
婚	女Ｃ日
婢	女卑卑
婧	女青Ｊ
婪	林女Ｌ
婴	贝贝女
婵	女丷十
婶	女宀丨
婷	女亮丁
婺	龴攵女
婿	女乛冃
媒	女廿木
媚	女尸目
媛	女爫又
媪	女日皿
媲	女白比
媳	女丿心
媵	月龹女
媸	女屮虫
媾	女井冂
嫁	女宀豕
嫂	女叟Ｓ
嫉	女疒矢
嫌	女首兼
嫒	女爱爱
嫔	女穴丘
嫖	女覀示
嫘	女田小
嫜	女章Ｚ
嫠	未厂女
嫡	女啇Ｄ
嫣	女一Ｓ
嫦	女尚巾
嫩	女木攵
嫫	女莫Ｍ
嫱	女十囗
嬉	女吉口
嬖	尸辛女
嬗	女亠一
嬴	赢赢女
嬷	女广厶
孀	女雨目
子	子ＺＩ
孑	孑ＪＥ
孓	乛亅丶
孔	子乚Ｋ
孕	乃子Ｙ
字	宀子Ｚ
存	Ｐ子Ｃ
孙	子小Ｓ
孚	爫子Ｆ
孛	十冖子
孜	子攵Ｚ
孝	耂子Ｘ
孟	子皿Ｍ
孢	子包Ｂ
季	禾子Ｊ
孤	子瓜Ｇ
孥	女又子
学	学子Ｘ
孩	子亥Ｈ
孪	亦子Ｌ
孬	不女子
孰	高子九
孱	尸子子
孳	首幺子
孵	Ｇ爫子
孺	子雨皿
孽	艹追子
宁	宁ＮＧ
它	宀匕Ｔ
宄	宀九Ｇ
宅	宀丿七
宇	宀于Ｙ
守	宀寸Ｓ
安	安安Ａ
宋	宀木Ｓ
完	宀元Ｗ
宏	宀厂厶
宓	宀心丿
宕	宀石Ｄ
宗	宀示Ｚ
官	宀官Ｇ
宙	宀由Ｚ
定	宀一止
宛	宀夕㔾
宜	宀且Ｙ
宝	宀王丶
实	宀头Ｓ
宠	宀龙Ｃ
审	宀日丨
客	宀各Ｋ
宣	宀一一
室	宀一土
宥	宀厂冃
宦	宀匚丨
宪	宀牛儿
宫	宀口口
宰	宀辛Ｚ
害	宀丰口
宴	宀日女
宵	宀Ｍ冃
家	宀豕Ｊ
宸	宀厂ｒ
容	宀谷Ｒ
宽	宀艹见
宾	穴丘Ｂ
宿	宀亻日
寂	宀小又
寄	宀大可
寅	穴一由
密	宀心山
寇	宀元卜
富	宀畐Ｆ
寐	宀爿未
寒	宀井冫
寓	宀甲冂
寝	宀丬又
寞	宀莫Ｍ
察	宀祭示
寡	宀丆分
寤	宀爿口
寥	宀羽彡
寨	宀井朩
寮	宀大小
寰	宀罒ｒ
寸	寸ＣＮ
对	又寸Ｄ
寺	土寸Ｓ
寻	彐寸Ｘ
导	巳寸Ｄ
寿	丰寸Ｓ
封	圭寸Ｆ
射	身寸Ｓ
将	丬夕寸
尉	尸示寸
尊	酋寸Ｚ
小	小ＸＯ
少	少ＳＯ
尔	刀小Ｅ
尕	乃小Ｇ
尖	小大Ｊ
尘	小土Ｃ
尚	尚ＳＧ
尜	小大小
尝	龸云Ｃ
尢	尢ＷＧ
尤	尢丶Ｙ
尥	尢勹丶
尧	戈一儿
尬	尢人刂
就	高小尢
尴	尢刂Ｋ
尸	尸ＳＩ
尹	彐丿Ｙ
尺	尺ＣＩ
尺	尺ＣＥ
尻	尸九Ｋ
尼	尸匕Ｎ
尽	尺冫Ｊ
尾	尸毛Ｗ
尾	尸毛Ｙ
尿	尸水Ｎ
尿	尸水Ｓ
局	尸亅口
屁	尸比Ｐ
层	尸云Ｃ
居	尸古Ｊ
屈	尸出Ｑ
屉	尸世Ｔ
届	尸由Ｊ
屋	尸一土
屎	尸米Ｓ
屏	尸首廾
屐	尸彳又
屑	尸Ｍ冃
展	尸龷ｒ
屙	尸阝可
属	尸丿冂
屠	尸者Ｔ
屡	尸米女
屣	尸彳止
履	尸彳夂
屦	尸彳女
屯	七凵Ｔ
山	山ＳＮ
屹	山人乙
屺	山己Ｑ
屿	山与Ｙ
岁	山夕Ｓ
岂	山己Ｑ
岈	山一才
岌	山及Ｊ
岍	山一廾
岐	山十又
岑	山亽乛
岔	分山Ｃ
岖	山匚乂
岗	山冂乂
岘	山见Ｘ
岙	丿大山
岚	山风Ｌ
岛	鸟山Ｄ
岜	山巴Ｂ
岢	山可Ｋ
岣	山勹口
岩	山石Ｙ
岫	山由Ｘ
岬	山甲Ｊ
岭	山亽龴
岱	代山Ｄ
岳	丘山Ｙ
岵	山古Ｈ
岷	山巳七
岸	山厂干
岽	山七小
岿	山刂彐
峁	山Ｇ卩
峄	山又干
峋	山勹日
峒	山冂一
峙	山土寸
峡	山夫丷
峤	山丿刂
峥	山刀亅
峦	亦山Ｌ
峨	山手戈
峪	山谷Ｙ
峭	山Ｍ冃
峰	山夂丰
峻	山厶夂
崂	山营力
崃	山未丷
崆	山穴工
崇	山宀示
崎	山大可
崔	山隹Ｃ
崖	山厂圭
崛	山尸出
崞	山高子
崤	山乂冃
崦	山大乚
崧	山木厶
崩	山月月
崭	山车斤
崮	山囗古
崴	山戊一
崽	山田心
崾	山覀女
嵇	禾丶山
嵊	山禾丬
嵋	山尸目
嵌	山廿欠
嵘	山营木
嵛	山亼前
嵝	山米女
嵩	山高Ｓ
嵫	山首幺
嵬	山白儿
嵯	山羊工
嵴	山Ｋ月
嶂	山章Ｚ
嶙	山米舛
嶝	山癶首
嶷	山矢止
巅	山八页
巍	山女儿
川	川ＣＮ
州	州ＺＵ
巡	巛辶Ｘ
巢	巛日木
工	工ＧＧ
左	厂工Ｚ
巧	工丂Ｑ
巨	匚尸Ｊ
巩	工几丶
巫	工人人
差	羊工Ｃ
巯	又工川
己	己ＪＩ
已	已ＹＩ
巳	巳ＳＩ
巴	巴ＢＡ
巷	龷八巳
巽	巳巳八
巾	巾ＪＮ
币	丿巾Ｂ
市	亠巾Ｓ
布	厂巾Ｂ
帅	刂巾Ｓ
帆	巾几丶
师	刂一巾
希	乂厂巾
帏	巾二卩
帐	巾长Ｚ
帑	女又巾
帔	巾皮Ｐ
帕	巾白Ｐ
帖	巾占占
帘	穴巾Ｌ
帙	巾失Ｚ
帚	彐冖巾
帛	白巾Ｂ
帜	巾口八
帝	旁巾Ｄ
带	卅冖巾
帧	巾卜贝
席	广廿巾
帮	丰阝巾
帱	巾丰寸
帷	巾隹Ｗ
常	尚巾Ｃ
帻	巾龶贝
帼	巾囗王
帽	巾日目
幂	冖日巾
幄	巾尸土
幅	巾畐Ｆ
幌	巾日儿
幔	巾日又
幕	莫巾Ｍ
幛	巾章Ｚ
幞	巾业丶
幡	巾丿田
幢	巾立里
干	干ＧＮ
平	干丷Ｐ
年	人井Ｎ
并	首廾Ｂ
幸	土首十
幺	幺ＹＯ
幻	幺亅Ｈ
幼	幺力Ｙ
幽	山幺幺
广	广ＧＧ
庄	广土Ｚ
庆	广大Ｑ
庇	广比Ｂ
床	广木Ｃ
庋	广十又
序	广龴丁
庐	广户Ｌ
庑	广干乚
库	广车Ｋ
应	广兴Ｙ
底	广Ｃ七
庖	广包Ｐ
店	广占占
庙	广由Ｍ
庚	广彐人
府	广亻寸
庞	广龙Ｐ
废	广发Ｆ
庠	广羊Ｘ
庥	广亻木
度	广廿又
座	广人土
庭	广壬廴
庳	广卑卑
庵	广大乚
庶	广廿灬
康	广彐水
庸	广彐冃
庹	广廿尺
庾	广臼人
廉	广首兼
廊	广丶阝
廑	广廿龶
廒	广敖Ａ
廓	广高阝
廖	广羽彡
廛	广里土
廨	广刀牛
廪	广亠示
延	丿止廴
廷	壬廴Ｔ
建	彐干廴
廿	廿ＮＮ
开	一廾Ｋ
弁	厶廾Ｂ
异	巳廾Ｙ
弃	充廾Ｑ
弄	王廾Ｎ
弄	王廾Ｌ
弈	亦廾Ｙ
弊	丷攵廾
弋	弋ＹＩ
式	弋工Ｓ
弑	乂朩弋
弓	弓ＧＧ
引	弓丨Ｙ
弗	弓刂Ｆ
弘	弓厶Ｈ
弛	弓也Ｃ
弟	丷弓丿
张	弓长Ｚ
弥	弓刀小
弦	弓玄Ｘ
弧	弓瓜Ｈ
弩	女又弓
弭	弓耳Ｍ
弯	亦弓Ｗ
弱	弓冫弓
弹	弓丷十
强	弓虽Ｑ
强	弓虽Ｊ
弼	弓丆弓
彀	士弓殳
归	刂彐Ｇ
当	Ｍ彐Ｄ
录	彐水Ｌ
彖	彑豕Ｔ
彗	丰丰彐
彘	彑矢比
彝	彑米廾
形	一廾彡
彤	冂亠彡
彦	立丿彡
彩	爫木彡
彪	虍几彡
彬	林彡Ｂ
彭	吉首彡
彰	章彡Ｚ
影	日小彡
彳	彳ＣＩ
彷	彳方Ｐ
役	彳殳Ｙ
彻	彳七刀
彼	彳皮Ｂ
往	彳主Ｗ
征	彳一止
徂	彳且Ｃ
径	彳又工
待	彳土寸
徇	彳勹日
很	彳艮Ｈ
徉	彳羊Ｙ
徊	彳囗口
律	彳彐干
徐	彳余Ｘ
徒	彳走Ｔ
徕	彳未丷
得	彳日寸
徘	彳非Ｐ
徙	彳止止
徜	彳尚Ｃ
御	彳人卩
徨	彳白王
循	彳厂目
徭	彳爫缶
微	微微几
徵	微微王
德	彳十心
徼	彳白攵
徽	微微幺
心	心ＸＮ
必	心丿Ｂ
忆	忄乙Ｙ
忉	忄刀Ｄ
忌	己心Ｊ
忍	刀丶心
忏	忄千Ｃ
忐	卜一心
忑	下心Ｔ
忒	弋心Ｔ
忖	忄寸Ｃ
志	士心Ｚ
忘	亡心Ｗ
忙	忄亡Ｍ
忝	一大小
忠	口丨心
忡	忄口丨
忤	忄午Ｗ
忧	忄尢丶
忪	忄八厶
快	忄夬Ｋ
忭	忄亠卜
忮	忄十又
忱	忄巾乚
念	亽乛心
忸	忄丑Ｎ
忻	忄斤Ｘ
忽	勹彳心
忾	忄气Ｋ
忿	分心Ｆ
怀	忄不Ｈ
态	大丶心
怂	人人心
怃	忄干乚
怄	忄匚乂
怅	忄长Ｃ
怆	忄仓Ｃ
怊	忄召Ｃ
怍	忄乍Ｚ
怎	乍心Ｚ
怏	忄央Ｙ
怒	女又心
怔	忄一止
怕	忄白Ｐ
怖	忄厂巾
怙	忄古Ｈ
怛	忄日一
怜	忄亽龴
思	田心Ｓ
怠	厶口心
怡	忄厶口
急	刀彐心
怦	忄干丷
性	忄丿龶
怨	夕㔾心
怩	忄尸匕
怪	忄又土
怫	忄弓刂
怯	忄土厶
怵	忄木丶
总	丷口心
怼	又寸心
怿	忄又干
恁	亻壬心
恂	忄勹日
恃	忄土寸
恋	亦心Ｌ
恍	忄Ｍ儿
恐	工几心
恒	忄一一
恕	女口心
恙	<美上>心Ｙ
恚	圭心Ｈ
恝	丰刀心
恢	忄厂火
恣	冫欠心
恤	忄丿皿
恧	丆皿心
恨	忄艮Ｈ
恩	囗大心
恪	忄各Ｋ
恫	忄冂一
恬	忄舌Ｔ
恭	龷八小
息	丿目心
恰	忄亼口
恳	艮心Ｋ
恶	亚心Ｅ
恶	亚心Ｗ
恸	忄云力
恹	忄厂大
恺	忄山己
恻	忄贝刂
恼	忄文凵
恽	忄冖车
恿	龴用心
悃	忄囗木
悄	忄Ｍ冃
悉	丿米心
悌	忄丷弓
悍	忄日干
悒	忄口巴
悔	忄人母
悖	忄十子
悚	忄木口
悛	忄厶夂
悝	忄里Ｋ
悟	忄五口
悠	亻攵心
患	口口心
悦	忄丷儿
您	亻刀心
悫	士冖心
悬	且厶心
悭	忄又土
悯	忄门文
悱	忄非Ｆ
悲	非心Ｂ
悴	忄亠十
悸	忄禾子
悻	忄土十
悼	忄卜十
情	忄青Ｑ
惆	忄冂土
惊	忄高小
惋	忄宀㔾
惑	戈口心
惕	忄日勹
惘	忄冂首
惚	忄勹心
惜	忄龷日
惝	忄尚Ｃ
惟	忄隹Ｗ
惠	士日心
惦	忄广占
惧	忄且八
惨	忄厶彡
惩	彳一心
惫	夂田心
惬	忄匚夫
惭	忄车斤
惮	忄丷十
惯	忄毌贝
惰	忄厂冃
想	木目心
惴	忄山皿
惶	忄白王
惹	艹厂心
惺	忄日龶
愀	忄禾火
愁	禾火心
愆	彳亍心
愈	亼前心
愉	忄亼前
愍	巳攵心
愎	忄人夂
意	立日心
愕	忄口Ｓ
愚	甲冂心
感	戊一心
愠	忄日皿
愣	忄罒方
愤	忄十贝
愦	忄贵Ｋ
愧	忄白儿
愫	忄龶小
愿	厂白心
慈	首幺心
慊	忄首兼
慌	忄艹川
慎	忄十八
慑	忄耳又
慕	莫小Ｍ
慝	匚艹心
慢	忄日又
慧	丰丰心
慨	忄艮旡
慰	尸寸心
慵	忄广冃
慷	忄广水
憋	丷攵心
憎	忄丷日
憔	忄焦Ｑ
憧	忄立里
憨	乛攵心
憩	舌丿心
憬	忄日小
憷	忄林止
憾	忄戊心
懂	忄艹里
懈	忄刀牛
懊	忄白大
懋	木木心
懑	氵艹心
懒	忄木负
懔	忄亠示
懦	忄雨皿
懵	忄艹目
懿	士首心
戆	章夂心
戈	戈ＧＥ
戊	戊ＷＵ
戋	一戈Ｊ
戌	戊一Ｘ
戌	戊一Ｑ
戍	戊丶Ｓ
戎	戈厂Ｒ
戏	又戈Ｘ
成	戊亅Ｃ
我	手戈Ｗ
戒	戈廾Ｊ
戕	爿戈Ｑ
或	戈口一
戗	仓戈Ｑ
战	占占戈
戚	戊卜一
戛	丆目戈
戟	十十戈
戡	其乚戈
戢	口耳戈
戤	乃皿戈
戥	日龶戈
截	十戈隹
戬	亚日戈
戮	羽彡戈
戳	羽隹戈
戴	十戈八
户	户ＨＵ
戽	户斗Ｈ
戾	户大丶
房	户方Ｆ
所	厂尸斤
扁	户冊Ｂ
扁	户冊Ｐ
扃	户冂口
扇	户羽Ｓ
扈	户口巴
扉	户非Ｆ
手	手ＳＵ
才	才ＣＩ
扎	扌乚Ｚ
扑	扌卜Ｐ
扒	扌八Ｂ
扒	扌八Ｐ
打	扌丁Ｄ
扔	扌乃Ｒ
托	扌丿七
扛	扌工Ｋ
扛	扌工Ｇ
扣	扌口Ｋ
扦	扌千Ｑ
执	执执Ｚ
扩	扌广Ｋ
扪	扌门Ｍ
扫	扌彐Ｓ
扬	扌Ｊ彳
扭	扌丑Ｎ
扮	扌分Ｂ
扯	扌止Ｃ
扰	扌尢丶
扳	扌反反
扶	扌夫Ｆ
批	扌比Ｐ
扼	扌厂㔾
找	扌戈Ｚ
承	乛水三
技	扌十又
抄	扌少Ｃ
抉	扌夬Ｊ
把	扌巴Ｂ
抑	扌Ｃ卩
抒	扌龴丁
抓	扌爪Ｚ
投	扌殳Ｔ
抖	扌斗Ｄ
抗	扌亠几
折	扌斤Ｚ
折	扌斤Ｓ
抚	扌干乚
抛	扌九力
抟	扌二龴
抠	扌匚乂
抡	扌人匕
抢	扌仓Ｑ
护	扌户Ｈ
报	扌卩又
抨	扌干丷
披	扌皮Ｐ
抬	扌厶口
抱	扌包Ｂ
抵	扌Ｃ七
抹	扌末Ｍ
抻	扌日丨
押	扌甲Ｙ
抽	扌由Ｃ
抿	扌巳七
拂	扌弓刂
拄	扌主Ｚ
担	扌日一
拆	扌斤丶
拇	扌母Ｍ
拈	扌占占
拉	扌立Ｌ
拊	扌亻寸
拌	扌半Ｂ
拍	扌白Ｐ
拎	扌亽龴
拐	扌另Ｇ
拒	扌匚尸
拓	扌石Ｔ
拔	扌犮Ｂ
拖	扌人也
拗	扌幺力
拘	扌勹口
拙	扌出Ｚ
招	扌召Ｚ
拜	龵一丰
拟	扌以Ｎ
拢	扌龙Ｌ
拣	扌七小
拥	扌用Ｙ
拦	扌首二
拧	扌宁Ｎ
拨	扌发Ｂ
择	扌又干
括	扌舌Ｋ
拭	扌弋工
拮	扌吉Ｊ
拯	扌乛一
拱	扌龷八
拳	龹手Ｑ
拴	扌全Ｓ
拶	扌巛夕
拷	扌耂丂
拼	扌首廾
拽	扌日乚
拾	扌亼口
拿	亼口手
持	扌土寸
挂	扌圭Ｇ
指	扌匕日
挈	丰刀手
按	扌安安
挎	扌大Ｓ
挑	扌ＫＫ
挖	扌穴乙
挚	执执手
挛	亦手Ｌ
挝	扌寸辶
挞	扌大辶
挟	扌夫丷
挠	扌戈儿
挡	扌Ｍ彐
挣	扌刀亅
挤	扌文刂
挥	扌冖车
挨	扌厶矢
挪	扌月阝
挫	扌人土
振	扌厂ｒ
挲	氵少手
挹	扌口巴
挺	扌壬廴
挽	扌刀儿
捂	扌五口
捃	扌彐口
捅	扌龴用
捆	扌囗木
捉	扌足Ｚ
捋	扌爫寸
捌	扌另刂
捍	扌日干
捎	扌Ｍ冃
捏	扌日土
捐	扌口冃
捕	扌甫Ｂ
捞	扌营力
损	扌口贝
捡	扌亼兴
换	扌刀大
捣	扌鸟山
捧	扌<春上>干
捩	扌户大
捭	扌卑卑
据	扌尸古
捶	扌千垂
捷	扌一止
捺	扌大示
捻	扌亽心
掀	扌斤欠
掂	扌广占
掇	扌又又
授	扌受Ｓ
掉	扌卜十
掊	扌立口
掌	尚手Ｚ
掎	扌大可
掏	扌勹缶
掐	扌刀臼
排	扌非Ｐ
掖	扌亠夂
掘	扌尸出
掠	扌高小
探	扌㓁木
掣	牛刂手
接	扌立女
控	扌穴工
推	扌隹Ｔ
掩	扌大乚
措	扌龷日
掬	扌勹米
掭	扌一小
掮	扌户冃
掰	龵分手
掳	扌虍力
掴	扌囗王
掷	扌丷阝
掸	扌丷十
掺	扌厶彡
掼	扌毌贝
掾	扌彑豕
揄	扌亼前
揆	扌癶大
揉	扌龴木
揍	扌<春上>大
描	扌艹田
提	扌日止
插	扌千臼
揖	扌口耳
揠	扌匚日
握	扌尸土
揣	扌山皿
揩	扌比白
揪	扌禾火
揭	扌日勹
援	扌爫又
揶	扌耳阝
揸	扌木一
揽	扌Ｋ见
揿	扌钅欠
搀	扌刀冫
搁	扌门各
搂	扌米女
搅	扌学见
搋	扌厂几
搌	扌尸ｒ
搏	扌甫寸
搐	扌玄田
搓	扌羊工
搔	扌又虫
搛	扌首兼
搜	扌叟Ｓ
搞	扌高Ｇ
搠	扌丷月
搡	扌又木
搦	扌弓弓
搪	扌广口
搬	扌舟殳
搭	扌艹口
搴	宀井手
携	扌隹乃
搽	扌艹朩
摁	扌囗心
摄	扌耳又
摅	扌虍心
摆	扌罒厶
摇	扌爫缶
摈	扌穴丘
摊	扌又隹
摒	扌尸廾
摔	扌亠十
摘	扌啇Ｚ
摞	扌田小
摧	扌山隹
摩	广林手
摭	扌广灬
摸	扌莫Ｍ
摹	莫手Ｍ
撂	扌田各
撄	扌贝女
撅	扌厂欠
撇	扌丷攵
撑	扌尚手
撒	扌龷攵
撕	扌其斤
撖	扌乛攵
撙	扌酋寸
撞	扌立里
撤	扌充攵
撩	扌大小
撬	扌毛毛
播	扌丿田
撮	扌日又
撰	扌巳八
撵	扌夫车
撷	扌吉页
撸	扌鱼日
撺	扌穴丨
撼	扌戊心
擀	扌人干
擂	扌雨田
擅	扌亠一
操	扌口木
擎	艹攵手
擐	扌罒ｒ
擒	扌人冂
擘	尸辛手
擞	扌米攵
擢	扌羽隹
擤	扌丿丌
擦	扌宀示
攀	木木手
攉	扌雨隹
攒	扌牛贝
攘	扌衣口
攥	扌竹小
攫	扌目又
攮	扌十ｒ
支	十又Ｚ
收	丩攵Ｓ
攸	亻丨攵
改	己攵Ｇ
攻	工攵Ｇ
放	方攵Ｆ
政	一止攵
故	古攵Ｇ
效	亠父攵
敉	米攵Ｍ
敌	舌攵Ｄ
敏	人母攵
救	氺丶攵
敕	木口攵
敖	敖ＡＯ
教	耂子攵
敛	亼兴攵
敝	丷巾攵
敞	尚攵Ｃ
敢	乛耳攵
散	龷冃攵
敦	高子攵
敫	白方攵
敬	艹口攵
数	米女攵
敲	高卜又
整	木攵止
敷	甫方攵
文	文ＷＮ
斋	文丆皿
斌	文一弋
斐	非文Ｆ
斑	王文王
斓	文门木
斗	斗ＤＵ
料	米斗Ｌ
斛	刀用斗
斜	余斗Ｘ
斟	其乚斗
斡	十十斗
斤	斤ＪＮ
斥	斤丶Ｃ
斧	父斤Ｆ
斩	车斤Ｚ
斫	石斤Ｚ
断	米乚斤
斯	其斤Ｓ
新	亲斤Ｘ
方	方ＦＧ
於	方人冫
施	族也Ｓ
旁	旁方Ｐ
旃	族冂亠
旄	族毛Ｍ
旅	族丿ｒ
旆	族一巾
旋	族乛止
旌	族丿龶
旎	族尸匕
族	族矢Ｚ
旒	族充川
旖	族大可
旗	族其Ｑ
无	干乚Ｗ
无	干乚Ｍ
既	艮旡Ｊ
日	日ＲＩ
旦	日一Ｄ
旧	丨日Ｊ
旨	匕日Ｚ
早	日十Ｚ
旬	勹日Ｘ
旭	九日Ｘ
旮	九日Ｇ
旯	日九Ｌ
旰	日干Ｇ
旱	日干Ｈ
时	日寸Ｓ
旷	日广Ｋ
旺	日王Ｗ
昀	日勹冫
昂	日Ｃ卩
昃	日厂人
昆	日比Ｋ
昊	日一大
昌	日日Ｃ
明	日月Ｍ
昏	Ｃ七日
易	日勹彳
昔	龷日Ｘ
昕	日斤Ｘ
昙	日云Ｔ
昝	夂卜日
星	日丿龶
映	日央Ｙ
春	<春上>日Ｃ
昧	日未Ｍ
昨	日乍Ｚ
昭	日召Ｚ
是	日一止
昱	日立Ｙ
昴	日Ｇ卩
昵	日尸匕
昶	丶水日
昼	尺日一
显	日业Ｘ
晁	日ＫＫ
晃	日Ｍ儿
晋	亚日Ｊ
晌	日白口
晏	日安安
晒	日西Ｓ
晓	日戈儿
晔	日匕十
晕	日冖车
晖	日冖车
晗	日亽口
晚	日刀儿
晟	日戊亅
晡	日甫Ｂ
晤	日五口
晦	日人母
晨	日厂ｒ
普	首业日
景	日高小
晰	日木斤
晴	日青Ｑ
晶	日日日
晷	日夂口
智	矢口日
晾	日高小
暂	车斤日
暄	日宀一
暇	日尸又
暌	日癶大
暑	日者Ｓ
暖	日爫又
暗	日立日
暝	日冖八
暧	日爱爱
暨	艮旡一
暮	莫日Ｍ
暴	日龷氺
暹	日隹辶
暾	日高攵
曙	日罒者
曛	日千黑
曜	日羽隹
曝	日日氺
曦	日<美上>戈
曩	日衣口
曰	曰ＹＥ
曲	日刂Ｑ
曳	日乚丿
更	丈日Ｇ
曷	日勹乚
曹	西日Ｃ
曼	日罒又
曾	丷日日
替	夫夫日
最	日耳又
月	月ＹＥ
有	厂冃Ｙ
朋	月月Ｐ
服	月卩又
朐	月勹口
朔	丷屮月
朕	月丷大
朗	丶艮月
望	亡月王
朝	十十月
期	其月Ｑ
期	其月Ｊ
朦	月营豕
木	木ＭＵ
未	未ＷＩ
末	末ＭＯ
本	木一Ｂ
札	木乚Ｚ
术	木丶Ｓ
术	木丶Ｚ
朱	朱ＺＵ
朴	木卜Ｐ
朵	几木Ｄ
机	木几Ｊ
朽	木丂Ｘ
杀	乂朩Ｓ
杂	九朩Ｚ
权	木又Ｑ
杆	木干Ｇ
杈	木又丶
杉	木彡Ｓ
杌	木一儿
李	木子Ｌ
杏	木口Ｘ
材	木才Ｃ
村	木寸Ｃ
杓	木勹丶
杖	木丈Ｚ
杜	木土Ｄ
杞	木己Ｑ
束	木口Ｓ
杠	木工Ｇ
条	夂朩Ｔ
来	未丷Ｌ
杨	木Ｊ彳
杩	木马Ｍ
杪	木少Ｍ
杭	木亠几
杯	木不Ｂ
杰	木灬Ｊ
杲	日木Ｇ
杳	木日Ｙ
杵	木午Ｃ
杷	木巴Ｐ
杼	木龴丁
松	木八厶
板	木反反
极	木及Ｊ
构	木勹厶
枇	木比Ｐ
枉	木王Ｗ
枋	木方Ｆ
析	木斤Ｘ
枕	木巾乚
林	林ＬＮ
枘	木内Ｒ
枚	木攵Ｍ
果	日木Ｇ
枝	木十又
枞	木人人
枢	木匚乂
枣	木冂冫
枥	木厂力
枧	木见Ｊ
枨	木长Ｃ
枪	木仓Ｑ
枫	木风Ｆ
枭	鸟木Ｘ
枯	木古Ｋ
枰	木干丷
枳	木口八
枵	木口丂
架	加木Ｊ
枷	木加Ｊ
枸	木勹口
柁	木宀匕
柃	木亽龴
柄	木一内
柏	木白Ｂ
某	廿一木
柑	木廿一
柒	氵七木
染	氵九木
柔	龴才木
柘	木石Ｚ
柙	木甲Ｘ
柚	木由Ｙ
柜	木匚尸
柝	木斤丶
柞	木乍Ｚ
柠	木宁Ｎ
柢	木Ｃ七
查	木日一
柩	木匚刀
柬	木柬Ｊ
柯	木可Ｋ
柰	木示Ｎ
柱	木主Ｚ
柳	木Ｇ卩
柴	止匕木
柽	木又土
柿	木亠巾
栀	木Ｆ㔾
栅	木册Ｓ
栅	木册Ｚ
标	木示Ｂ
栈	木一戈
栉	木艹卩
栊	木龙Ｌ
栋	木七小
栌	木卜尸
栎	木Ｃ小
栏	木首二
树	木又寸
栓	木全Ｓ
栖	木西Ｑ
栗	覀木Ｌ
栝	木舌Ｇ
校	木亠父
栩	木羽Ｘ
株	木朱Ｚ
栲	木耂丂
栳	木耂匕
样	木羊Ｙ
核	木亥Ｈ
根	木艮Ｇ
格	木各Ｇ
栽	十戈木
栾	亦木Ｌ
桀	夕舛木
桁	木彳亍
桂	木圭Ｇ
桃	木ＫＫ
桄	木Ｍ儿
桅	木刀㔾
框	木匚王
案	安安木
桉	木安安
桊	龹木Ｊ
桌	卜日木
桎	木一土
桐	木冂一
桑	又又木
桓	木一一
桔	木吉Ｊ
桕	木臼Ｊ
桠	木亚Ｙ
桡	木戈儿
桢	木卜贝
档	木Ｍ彐
桤	木山己
桥	木丿刂
桦	木匕十
桧	木人云
桨	丬夕木
桩	木广土
桫	木氵少
桴	木爫子
桶	木龴用
桷	木刀用
梁	氵刀木
梃	木壬廴
梅	木人母
梆	木丰阝
梏	木告Ｇ
梓	木辛Ｚ
梗	木丈日
梢	木Ｍ冃
梦	林夕Ｍ
梧	木五口
梨	禾刂木
梭	木厶夂
梯	木丷弓
械	木戈廾
梳	木充川
梵	林几丶
检	木亼兴
棂	木彐火
棉	木白巾
棋	木其Ｑ
棍	木日比
棒	木<春上>干
棕	木宀示
棘	木冂木
棚	木月月
棠	尚木Ｔ
棣	木彐水
森	木林Ｓ
棰	木千垂
棱	木土夂
棵	木日木
棹	木卜十
棺	木宀官
棼	林分Ｆ
椁	木高子
椅	木大可
椋	木高小
植	木十且
椎	木隹Ｚ
椐	木尸古
椒	木卜又
椟	木十头
椠	车斤木
椤	木罒夕
椭	木厂冃
椰	木耳阝
椴	木Ｅ殳
椹	木其乚
椽	木彑豕
椿	木<春上>日
楂	木木一
楔	木刀大
楗	木彐廴
楚	林乛止
楝	木木柬
楞	木罒方
楠	木Ｍ首
楣	木尸目
楦	木宀一
楫	木口耳
楮	木者Ｃ
楷	木比白
楸	木禾火
楹	木乃皿
楼	木米女
概	木艮旡
榄	木Ｋ见
榆	木亼前
榇	木亲Ｃ
榈	木门口
榉	木兴干
榍	木尸冃
榔	木丶阝
榕	木宀谷
榛	木<春上>禾
榜	木旁方
榧	木匚非
榨	木穴乍
榫	木隹十
榭	木身寸
榱	木衣口
榴	木刀田
榷	木冖隹
榻	木日羽
槁	木高Ｇ
槊	丷月木
槌	木追辶
槎	木羊工
槐	木白儿
槔	木白十
槛	木Ｋ皿
槟	木穴丘
槠	木讠者
槭	木戊卜
槲	木刀斗
槽	木西日
槿	木廿龶
樊	木木大
樗	木雨Ｓ
樘	木尚土
樟	木章Ｚ
模	木莫Ｍ
樨	木尸牛
横	木龷八
樯	木十囗
樱	木贝女
樵	木焦Ｑ
樽	木酋寸
樾	木走戈
橄	木乛攵
橇	木毛毛
橐	十口木
橘	木龴冂
橙	木癶首
橛	木厂欠
橡	木象Ｘ
橥	犭者木
橱	木厂寸
橹	木鱼日
橼	木彑豕
檀	木亠一
檄	木白攵
檎	木人冂
檐	木刀言
檑	木雨田
檗	尸辛木
檠	艹攵木
檩	木亠示
檫	木宀示
檬	木营豕
欠	欠ＱＮ
次	冫欠Ｃ
欢	又欠Ｈ
欣	斤欠Ｘ
欤	与欠Ｙ
欧	匚乂欠
欲	谷欠Ｙ
欹	大可欠
欺	其欠Ｑ
款	士示欠
歃	千臼欠
歆	立日欠
歇	日乚欠
歉	首兼欠
歌	可可欠
歙	亼羽欠
止	止ＺＩ
正	一止Ｚ
此	止匕Ｃ
步	止少Ｂ
武	一弋止
歧	止十又
歪	不一止
歹	歹ＤＩ
死	歹匕Ｓ
歼	歹千Ｊ
殁	歹殳Ｍ
殂	歹且Ｃ
殃	歹央Ｙ
殄	歹人彡
殆	歹厶口
殇	歹人Ｊ
殉	歹勹日
殊	歹朱Ｓ
残	歹一戈
殍	歹爫子
殒	歹口贝
殓	歹亼兴
殖	歹十且
殚	歹丷十
殛	歹乛一
殡	歹穴丘
殪	歹士首
殳	殳ＳＵ
殴	匚乂殳
段	Ｅ殳Ｄ
殷	厂彐殳
殿	尸龷殳
毁	臼工殳
毂	士车殳
毅	立豕殳
毋	毋ＷＵ
母	母ＭＵ
每	人母Ｍ
毒	龶母Ｄ
毓	人母川
比	比ＢＩ
毕	比十Ｂ
毖	比心丿
毗	田比Ｐ
毙	比歹匕
毛	毛ＭＯ
毡	毛占占
毪	毛厶牛
毫	亮毛Ｈ
毯	毛火火
毳	毛毛毛
毵	厶彡毛
毹	亼前毛
毽	毛彐干
氅	尚攵毛
氆	毛首业
氇	毛鱼日
氍	目隹毛
氏	Ｃ七Ｓ
氏	Ｃ七Ｚ
氐	Ｃ七丶
民	巳七Ｍ
氓	亡巳七
气	气ＱＩ
氕	气丿Ｐ
氖	气乃Ｎ
氘	气刂Ｄ
氙	气山Ｘ
氚	气川Ｃ
氛	气分Ｆ
氟	气弓刂
氡	气夂冫
氢	气又工
氤	气囗大
氦	气亥Ｈ
氧	气羊Ｙ
氨	气安安
氩	气亚Ｙ
氪	气古儿
氮	气火火
氯	气彐水
氰	气青Ｑ
氲	气日皿
水	水ＳＩ
永	丶水Ｙ
汀	氵丁Ｔ
汁	氵十Ｚ
求	氺丶Ｑ
汆	丿丶水
汇	氵匚Ｈ
汉	氵又Ｈ
汊	氵又丶
汐	氵夕Ｘ
汔	氵人乙
汕	氵山Ｓ
汗	氵干Ｈ
汛	氵乙十
汜	氵巳Ｓ
汝	氵女Ｒ
汞	工水Ｇ
江	氵工Ｊ
池	氵也Ｃ
污	氵二Ｓ
汤	氵Ｊ彳
汨	氵日Ｍ
汩	氵曰Ｇ
汪	氵王Ｗ
汰	氵大丶
汲	氵及Ｊ
汴	氵亠卜
汶	氵文Ｗ
汹	氵乂凵
汽	氵气Ｑ
汾	氵分Ｆ
沁	氵心Ｑ
沂	氵斤Ｙ
沃	氵丿大
沅	氵元Ｙ
沆	氵亠几
沈	氵巾乚
沉	氵冖几
沌	氵七凵
沏	氵七刀
沐	氵木Ｍ
沓	水日Ｄ
沓	水日Ｔ
沔	氵一亅
沙	氵少Ｓ
沛	氵一巾
沟	氵勹厶
没	氵殳Ｍ
沣	氵丰Ｆ
沤	氵匚乂
沥	氵厂力
沦	氵人匕
沧	氵仓Ｃ
沩	氵冫力
沪	氵户Ｈ
沫	氵末Ｍ
沭	氵木丶
沮	氵且Ｊ
沱	氵宀匕
河	氵可Ｈ
沸	氵弓刂
油	氵由Ｙ
治	氵厶口
沼	氵召Ｚ
沽	氵古Ｇ
沾	氵占占
沿	氵几口
泄	氵世Ｘ
泅	氵囗人
泉	白水Ｑ
泊	氵白Ｂ
泊	氵白Ｐ
泌	氵心丿
泐	氵阝力
泓	氵弓厶
泔	氵廿一
法	氵土厶
泖	氵Ｇ卩
泗	氵囗儿
泛	氵丿之
泞	氵宁Ｎ
泠	氵亽龴
泡	氵包Ｐ
波	氵皮Ｂ
泣	氵立Ｑ
泥	氵尸匕
注	氵主Ｚ
泪	氵目Ｌ
泫	氵玄Ｘ
泮	氵半Ｐ
泯	氵巳七
泰	<春上>氺Ｔ
泱	氵央Ｙ
泳	氵丶水
泵	石水Ｂ
泷	氵龙Ｌ
泷	氵龙Ｓ
泸	氵卜尸
泺	氵Ｃ小
泻	氵冖Ｓ
泼	氵发Ｐ
泽	氵又干
泾	氵又工
洁	氵吉Ｊ
洄	氵囗口
洇	氵囗大
洋	氵羊Ｙ
洌	氵歹刂
洎	氵丿目
洒	氵西Ｓ
洗	氵牛儿
洙	氵朱Ｚ
洚	氵夂舛
洛	氵各Ｌ
洞	氵冂一
津	氵彐干
洧	氵厂冃
洪	氵龷八
洫	氵丿皿
洮	氵ＫＫ
洱	氵耳Ｅ
洲	氵州Ｚ
洳	氵女口
洵	氵勹日
洹	氵一一
活	氵舌Ｈ
洼	氵圭Ｗ
洽	氵亼口
派	氵厂ｒ
流	氵充川
浃	氵夫丷
浅	氵一戈
浆	丬夕水
浇	氵戈儿
浈	氵卜贝
浊	氵虫Ｚ
测	氵贝刂
浍	氵人云
济	氵文刂
浏	氵文刂
浑	氵冖车
浒	氵讠午
浓	氵巾ｒ
浔	氵彐寸
浙	氵扌斤
浚	氵厶夂
浜	氵丘八
浞	氵足Ｚ
浠	氵乂巾
浣	氵宀元
浦	氵甫Ｐ
浩	氵告Ｈ
浪	氵丶艮
浮	氵爫子
浯	氵五口
浴	氵谷Ｙ
海	氵人母
浸	氵彐又
浼	氵刀儿
涂	氵余Ｔ
涅	氵日土
消	氵Ｍ冃
涉	氵止少
涌	氵龴用
涎	氵丿廴
涑	氵木口
涓	氵口冃
涔	氵山乛
涕	氵丷弓
涛	氵丰寸
涝	氵营力
涞	氵未丷
涟	氵车辶
涠	氵囗二
涡	氵口内
涣	氵刀大
涤	氵夂朩
润	氵门王
涧	氵门日
涨	氵弓长
涩	氵刀止
涪	氵立口
涫	氵宀官
涮	氵尸刂
涯	氵厂圭
液	氵亠夂
涵	氵乛凵
涸	氵囗古
涿	氵豕丶
淀	氵宀止
淄	氵巛田
淅	氵木斤
淆	氵乂冃
淇	氵其Ｑ
淋	氵林Ｌ
淌	氵尚Ｔ
淑	氵卜又
淖	氵卜十
淘	氵勹缶
淙	氵宀示
淝	氵月巴
淞	氵八厶
淠	氵田丌
淡	氵火火
淤	氵人冫
淦	氵金Ｇ
淫	氵爫壬
淬	氵亠十
淮	氵隹Ｈ
深	氵㓁木
淳	氵高子
混	氵日比
淹	氵大乚
添	氵一小
淼	水水水
清	氵青Ｑ
渊	氵刂米
渌	氵彐水
渍	氵龶贝
渎	氵十头
渐	氵车斤
渑	氵口乚
渔	氵鱼Ｙ
渗	氵厶彡
渚	氵者Ｚ
渝	氵亼前
渠	氵匚木
渡	氵广又
渣	氵木一
渤	氵十力
渥	氵尸土
温	氵日皿
渫	氵世木
渭	氵田冃
港	氵龷巳
渲	氵宀一
渴	氵日勹
游	氵族子
渺	氵目少
湃	氵一丰
湄	氵尸目
湍	氵山皿
湎	氵丆罒
湓	氵分皿
湔	氵首前
湖	氵古月
湘	氵木目
湛	氵其乚
湟	氵白王
湫	氵禾火
湮	氵覀土
湾	氵亦弓
湿	氵日业
溃	氵贵Ｋ
溃	氵贵Ｈ
溅	氵贝戈
溆	氵余又
溉	氵艮旡
溏	氵广口
源	氵厂小
溘	氵土皿
溜	氵刀田
溟	氵冖八
溢	氵首皿
溥	氵甫寸
溧	氵覀木
溪	氵爫大
溯	氵丷月
溱	氵<春上>禾
溲	氵叟Ｓ
溴	氵丿大
溶	氵宀谷
溷	氵囗豕
溺	氵弓弓
溻	氵日羽
溽	氵厂寸
滁	氵阝余
滂	氵旁方
滇	氵十八
滋	氵首幺
滏	氵父首
滑	氵骨Ｈ
滓	氵宀辛
滔	氵爫臼
滕	月龹氺
滗	氵竹毛
滚	氵衣八
滞	氵卅巾
滟	氵刀巴
滠	氵耳又
满	氵艹两
滢	氵营王
滤	氵虍心
滥	氵Ｋ皿
滦	氵亦木
滨	氵穴丘
滩	氵又隹
滴	氵啇Ｄ
滹	氵虍丁
漂	氵覀示
漆	氵木氺
漉	氵鹿比
漏	氵尸雨
漓	氵文冂
演	氵穴一
漕	氵西日
漠	氵莫Ｍ
漤	氵林女
漩	氵族止
漪	氵大可
漫	氵日又
漭	氵艹廾
漯	氵田小
漱	氵木欠
漳	氵章Ｚ
漶	氵口心
漾	氵<美上>水
潆	氵营小
潇	氵艹川
潋	氵亼攵
潍	氵纟隹
潘	氵丿田
潜	氵夫日
潞	氵足各
潢	氵龷八
潦	氵大小
潭	氵覀十
潮	氵十月
潲	氵Ｍ冃
潴	氵犭者
潸	氵林冃
潺	氵尸子
潼	氵立里
澄	氵癶首
澈	氵充攵
澉	氵乛攵
澌	氵其斤
澍	氵吉寸
澎	氵吉彡
澜	氵门木
澡	氵口木
澧	氵日首
澳	氵白大
澶	氵亠一
澹	氵刀言
激	氵白攵
濂	氵广兼
濉	氵目隹
濑	氵木负
濒	氵止页
濞	氵丿丌
濠	氵亮豕
濡	氵雨皿
濮	氵业丶
濯	氵羽隹
瀑	氵日氺
瀚	氵人羽
瀛	氵赢赢
瀣	氵又一
瀵	氵米八
瀹	氵亼冊
灌	氵艹隹
灏	氵日页
灞	氵雨月
火	火ＨＯ
灭	一火Ｍ
灯	火丁Ｄ
灰	厂火Ｈ
灵	彐火Ｌ
灶	火土Ｚ
灸	刀丶火
灼	火勹丶
灾	宀火Ｚ
灿	火山Ｃ
炀	火Ｊ彳
炅	日火Ｊ
炅	日火Ｇ
炉	火户Ｌ
炊	火欠Ｃ
炎	火火Ｙ
炒	火少Ｃ
炔	火夬Ｑ
炕	火亠几
炖	火七凵
炙	夕火Ｚ
炜	火二卩
炝	火仓Ｑ
炫	火玄Ｘ
炬	火匚尸
炭	山厂火
炮	火包Ｐ
炮	火包Ｂ
炯	火冂口
炱	厶口火
炳	火一内
炷	火主Ｚ
炸	火乍Ｚ
点	占占灬
炻	火石Ｓ
炼	火七小
炽	火口八
烀	火丿丁
烁	火Ｃ小
烂	火首二
烃	火又工
烈	歹刂灬
烊	火羊Ｙ
烘	火龷八
烙	火各Ｌ
烛	火虫Ｚ
烟	火囗大
烤	火耂丂
烦	火页Ｆ
烧	火戈儿
烨	火匕十
烩	火人云
烫	氵Ｊ火
烬	火尺冫
热	执执灬
烯	火乂巾
烷	火宀元
烹	高乛灬
烽	火夂丰
焉	一Ｓ灬
焊	火日干
焐	火五口
焓	火亽口
焕	火刀大
焖	火门心
焘	丰寸灬
焙	火立口
焚	林火Ｆ
焦	焦ＪＯ
焯	火卜十
焰	火刀臼
焱	火火火
然	夕丶灬
煅	火Ｅ殳
煊	火宀一
煌	火白王
煎	首前灬
煜	火日立
煞	刀攵灬
煤	火廿木
煦	日勹灬
照	日召灬
煨	火田ｒ
煮	者灬Ｚ
煲	亻口火
煳	火古月
煸	火户冊
煺	火艮辶
煽	火户羽
熄	火丿心
熊	厶匕灬
熏	千黑Ｘ
熔	火宀谷
熘	火刀田
熙	匚巳灬
熟	高九灬
熠	火羽白
熨	尸寸火
熬	敖灬Ａ
熵	火商Ｓ
熹	吉首灬
燃	火丶灬
燎	火大小
燔	火丿田
燕	廿口灬
燠	火白大
燥	火口木
燧	火首辶
燮	火火又
燹	豕豕火
爆	火日氺
爝	火爫寸
爨	臼冂火
爪	爪ＺＡ
爪	爪ＺＯ
爬	爪巴Ｐ
爰	爫干又
爱	爱爱Ａ
爵	爫艮寸
父	父ＦＵ
爷	父卩Ｙ
爸	父巴Ｂ
爹	父夕夕
爻	乂乂Ｙ
爽	大乂乂
爿	爿ＰＮ
片	片ＰＮ
版	片反反
牌	片卑卑
牍	片十头
牒	片世木
牖	片户甫
牙	一才Ｙ
牛	牛ＮＵ
牝	牜匕Ｐ
牟	厶牛Ｍ
牡	牜土Ｍ
牢	宀牛Ｌ
牦	牜毛Ｍ
牧	牜攵Ｍ
物	牜勹彳
牮	代牛Ｊ
牯	牜古Ｇ
牲	牜丿龶
牵	大冖牛
特	牜土寸
牺	牜西Ｘ
牾	牜五口
牿	牜告Ｇ
犀	尸氺牛
犁	禾刂牛
犄	牜大可
犊	牜十头
犋	牜且八
犍	牜彐廴
犏	牜户冊
犒	牜高Ｋ
犟	弓虽牛
犬	大丶Ｑ
犯	犭㔾Ｆ
犰	犭九Ｑ
犴	犭干Ａ
犴	犭干Ｈ
状	丬大丶
犷	犭广Ｇ
犸	犭马Ｍ
犹	犭尢丶
狁	犭厶儿
狂	犭王Ｋ
狃	犭丑Ｎ
狄	犭火Ｄ
狈	犭贝Ｂ
狍	犭包Ｐ
狎	犭甲Ｘ
狐	犭瓜Ｈ
狒	犭弓刂
狗	犭勹口
狙	犭且Ｊ
狞	犭宁Ｎ
狠	犭艮Ｈ
狡	犭亠父
狨	犭戈厂
狩	犭宀寸
独	犭虫Ｄ
狭	犭夫丷
狮	犭一巾
狯	犭人云
狰	犭刀亅
狱	犭大丶
狲	犭子小
狳	犭余Ｙ
狴	犭比土
狷	犭口冃
狸	犭里Ｌ
狺	犭言Ｙ
狻	犭厶夂
狼	犭丶艮
猁	犭禾刂
猃	犭亼兴
猊	犭臼儿
猎	犭龷日
猕	犭刀小
猖	犭日日
猗	犭大可
猛	犭子皿
猜	犭青Ｃ
猝	犭亠十
猞	犭亼古
猡	犭罒夕
猢	犭古月
猥	犭田ｒ
猩	犭日龶
猪	犭者Ｚ
猫	犭艹田
猬	犭田冃
献	Ｍ大丶
猱	犭龴木
猴	犭尸矢
猷	酋大丶
猹	犭木一
猾	犭骨Ｈ
猿	犭土ｒ
獍	犭竟Ｊ
獐	犭章Ｚ
獒	敖大丶
獗	犭厂欠
獠	犭大小
獬	犭刀牛
獭	犭木负
獯	犭千黑
獾	犭艹隹
玄	玄ＸＮ
率	亠幺十
玉	王丶Ｙ
王	王ＷＧ
玎	王丁Ｄ
玑	王几Ｊ
玖	王刀丶
玛	王马Ｍ
玟	王文Ｗ
玢	王分Ｆ
玢	王分Ｂ
玩	王元Ｗ
玫	王攵Ｍ
玮	王二卩
环	王不Ｈ
现	王见Ｘ
玲	王亽龴
玳	王代Ｄ
玷	王占占
玺	刀小王
玻	王皮Ｂ
珀	王白Ｐ
珂	王可Ｋ
珈	王加Ｊ
珉	王巳七
珊	王册Ｓ
珍	王人彡
珏	王王丶
珐	王土厶
珑	王龙Ｌ
珙	王龷八
珞	王各Ｌ
珠	王朱Ｚ
珥	王耳Ｅ
珧	王ＫＫ
珩	王彳亍
班	王刂王
珲	王冖车
球	王氺丶
琅	王丶艮
理	王里Ｌ
琉	王充川
琊	王一阝
琏	王车辶
琐	王Ｍ贝
琚	王尸古
琛	王㓁木
琢	王豕丶
琥	王虍几
琦	王大可
琨	王日比
琪	王其Ｑ
琬	王宀㔾
琮	王宀示
琰	王火火
琳	王林Ｌ
琴	王王乛
琵	王王比
琶	王王巴
琼	王高小
瑁	王日目
瑕	王尸又
瑗	王爫又
瑙	王巛白
瑚	王古月
瑛	王艹央
瑜	王亼前
瑞	王山皿
瑟	王心丿
瑭	王广口
瑰	王白儿
瑶	王爫缶
瑷	王爱爱
瑾	王廿龶
璀	王山隹
璁	王白心
璃	王文冂
璇	王族止
璋	王章Ｚ
璎	王贝女
璐	王足各
璜	王龷八
璞	王业丶
璧	尸辛王
璨	王又米
璩	王虍豕
璺	臼冂王
瓒	王牛贝
瓜	瓜ＧＡ
瓞	瓜失Ｄ
瓠	大Ｓ瓜
瓢	覀示瓜
瓣	辛瓜辛
瓤	衣口瓜
瓦	瓦ＷＡ
瓮	八厶瓦
瓯	匚乂瓦
瓴	亽龴瓦
瓶	首廾瓦
瓷	冫欠瓦
瓿	立口瓦
甄	覀土瓦
甍	艹罒瓦
甏	吉彡瓦
甑	丷日瓦
甓	尸辛瓦
甘	廿一Ｇ
甚	其乚Ｓ
甜	舌廿一
生	丿龶Ｓ
甥	丿龶力
用	用ＹＧ
甩	月乚Ｓ
甫	甫ＦＵ
甬	龴用Ｙ
甭	不用Ｂ
甯	宀心用
田	田ＴＮ
由	由ＹＵ
甲	甲ＪＡ
申	日丨Ｓ
电	日乚Ｄ
男	田力Ｎ
甸	勹田Ｄ
町	田丁Ｄ
画	一田凵
甾	巛田Ｚ
畀	田丌Ｂ
畅	日丨Ｊ
畈	田反反
畋	田攵Ｔ
界	田人刂
畎	田大丶
畏	田ｒＷ
畔	田半Ｐ
留	Ｃ刀田
畚	厶大田
畛	田人彡
畜	玄田Ｃ
畜	玄田Ｘ
略	田各Ｌ
畦	田圭Ｑ
番	丿米田
畲	人示田
畴	田丰寸
畸	田大可
畹	田宀㔾
畿	幺戈田
疃	田立里
疆	弓土一
疏	乛止川
疑	匕矢止
疔	疒丁Ｄ
疖	疒卩Ｊ
疗	疒乛亅
疙	疒人乙
疚	疒刀丶
疝	疒山Ｓ
疟	疒ＥＮ
疟	疒ＥＹ
疠	疒丆亅
疡	疒Ｊ彳
疣	疒尢丶
疤	疒巴Ｂ
疥	疒人刂
疫	疒殳Ｙ
疬	疒厂力
疮	疒仓Ｃ
疯	疒风Ｆ
疰	疒主Ｚ
疱	疒包Ｐ
疲	疒皮Ｐ
疳	疒廿一
疴	疒可Ｋ
疵	疒止匕
疸	疒日一
疹	疒人彡
疼	疒夂冫
疽	疒且Ｊ
疾	疒矢Ｊ
痂	疒加Ｊ
痃	疒玄Ｘ
痄	疒乍Ｚ
病	疒一内
症	疒一止
痈	疒用Ｙ
痉	疒又工
痊	疒全Ｑ
痍	疒大弓
痒	疒羊Ｙ
痔	疒土寸
痕	疒艮Ｈ
痘	疒一首
痛	疒龴用
痞	疒不口
痢	疒禾刂
痣	疒士心
痤	疒人土
痦	疒五口
痧	疒氵少
痨	疒营力
痪	疒刀大
痫	疒门木
痰	疒火火
痱	疒非Ｆ
痴	疒矢口
痹	疒田丌
痼	疒囗古
痿	疒禾女
瘀	疒方冫
瘁	疒亠十
瘃	疒豕丶
瘅	疒丷十
瘊	疒亻矢
瘌	疒木刂
瘐	疒臼人
瘕	疒尸又
瘗	疒夫土
瘘	疒米女
瘙	疒又虫
瘛	疒丰心
瘟	疒日皿
瘠	疒Ｋ月
瘢	疒舟殳
瘤	疒Ｃ田
瘥	疒羊工
瘦	疒叟Ｓ
瘩	疒艹口
瘪	疒丿匕
瘫	疒又隹
瘭	疒覀示
瘰	疒田小
瘳	疒羽彡
瘴	疒章Ｚ
瘵	疒祭示
瘸	疒加内
瘼	疒莫Ｍ
瘾	疒阝心
瘿	疒贝女
癀	疒龷八
癃	疒阝龶
癌	疒口山
癍	疒王王
癔	疒立心
癖	疒尸辛
癜	疒尸殳
癞	疒木负
癣	疒鱼羊
癫	疒十页
癯	疒目隹
癸	癶一大
登	癶一首
白	白ＢＩ
百	丆日Ｂ
皂	白七Ｚ
的	白勹丶
皆	比白Ｊ
皇	白王Ｈ
皈	白反反
皋	白大十
皎	白亠父
皑	白山己
皓	白告Ｈ
皖	白宀元
皙	木斤白
皤	白丿田
皮	皮ＰＩ
皱	刀彐皮
皲	冖车皮
皴	厶夂皮
皿	皿ＭＮ
盂	于皿Ｙ
盅	口丨皿
盆	分皿Ｐ
盈	乃又皿
益	首八皿
盍	土厶皿
盎	央皿Ａ
盏	一戈皿
盐	土卜皿
监	刂Ｋ皿
盒	亼口皿
盔	厂火皿
盖	<美上>皿Ｇ
盗	冫欠皿
盘	舟皿Ｐ
盛	戊亅皿
盟	日月皿
盥	臼水皿
目	目ＭＵ
盯	目丁Ｄ
盱	目于Ｘ
盲	亡目Ｍ
直	十且Ｚ
相	木目Ｘ
盹	目七凵
盼	目分Ｐ
盾	厂十目
省	少目Ｓ
省	少目Ｘ
眄	目一亅
眇	目少Ｍ
眈	目巾乚
眉	尸目Ｍ
看	龵目Ｋ
眍	目匚乂
眙	目厶口
眚	丿龶目
真	十且八
眠	目巳七
眢	夕㔾目
眦	目止匕
眨	目丿之
眩	目玄Ｘ
眭	目圭Ｓ
眯	目米Ｍ
眵	目夕夕
眶	目匚王
眷	龹目Ｊ
眸	目厶牛
眺	目ＫＫ
眼	目艮Ｙ
着	羊目Ｚ
睁	目刀亅
睃	目厶夂
睇	目丷弓
睐	目未丷
睑	目亼兴
睚	目厂圭
睛	目青Ｊ
睡	目千垂
睢	目隹Ｓ
督	卜又目
睥	目卑卑
睦	目土土
睨	目臼儿
睫	目一止
睬	目爫木
睹	目者Ｄ
睽	目癶大
睾	丿罒十
睿	卜冖目
瞀	龴攵目
瞄	目艹田
瞅	目禾火
瞌	目土皿
瞍	目叟Ｓ
瞎	目宀口
瞑	目冖八
瞒	目艹两
瞟	目覀示
瞠	目尚土
瞢	艹罒目
瞥	丷攵目
瞧	目焦Ｑ
瞩	目尸冂
瞪	目癶首
瞬	目爫舛
瞰	目乛攵
瞳	目立里
瞵	目米舛
瞻	目刀言
瞽	吉十目
瞿	目目隹
矍	目目又
矗	十且且
矛	龴才Ｍ
矜	龴才乛
矢	矢ＳＩ
矣	厶矢Ｙ
知	矢口Ｚ
矧	矢弓丨
矩	矢匚尸
矫	矢丿刂
矬	矢人土
短	矢一首
矮	矢禾女
石	石ＳＩ
石	石ＤＮ
矶	石几Ｊ
矸	石干Ｇ
矾	石几丶
矿	石广Ｋ
砀	石Ｊ彳
码	石马Ｍ
砂	石少Ｓ
砉	丰石Ｈ
砌	石七刀
砍	石欠Ｋ
砑	石一才
砒	石比Ｐ
研	石一廾
砖	石二龴
砗	石车Ｃ
砘	石七凵
砚	石见Ｙ
砜	石风Ｆ
砝	石土厶
砟	石乍Ｚ
砣	石宀匕
砥	石Ｃ七
砧	石占占
砬	石立Ｌ
砭	石丿之
砰	石干丷
破	石皮Ｐ
砷	石日丨
砸	石匚巾
砹	石艹乂
砺	石厂亅
砻	龙石Ｌ
砼	石人工
砾	石Ｃ小
础	石出Ｃ
硅	石圭Ｇ
硇	石白乂
硌	石各Ｇ
硎	石一刂
硐	石冂一
硒	石西Ｘ
硕	石页Ｓ
硖	石夫丷
硗	石戈儿
硝	石Ｍ冃
硪	石手戈
硫	石充川
硬	石丈日
硭	石艹亡
确	石刀用
硼	石月月
碇	石宀止
碉	石冂土
碌	石彐水
碍	石日寸
碎	石亠十
碑	石卑卑
碓	石隹Ｄ
碗	石宀㔾
碘	石冂八
碚	石立口
碛	石龶贝
碜	石厶彡
碟	石世木
碡	石龶母
碣	石日勹
碥	石户冊
碧	王白石
碰	石首业
碱	石戊一
碲	石旁巾
碳	石山火
碴	石木一
碹	石宀一
碾	石尸ｒ
磁	石首幺
磅	石旁方
磉	石又木
磊	石石石
磋	石羊工
磐	舟殳石
磔	石舛木
磕	石土皿
磙	石衣八
磨	广林石
磬	声殳石
磲	石匚木
磴	石癶首
磷	石米舛
礁	石焦Ｊ
礅	石高攵
礓	石一一
礞	石营豕
礴	石落寸
示	示ＳＩ
礼	礻乚Ｌ
社	礻土Ｓ
祀	礻巳Ｓ
祁	礻阝Ｑ
祆	礻一大
祈	礻斤Ｑ
祉	礻止Ｚ
祓	礻犮Ｆ
祖	礻且Ｚ
祗	礻Ｃ七
祚	礻乍Ｚ
祛	礻土厶
祜	礻古Ｈ
祝	礻口儿
神	礻日丨
祟	出示Ｓ
祠	礻亅一
祢	礻刀小
祥	礻羊Ｘ
祧	礻ＫＫ
票	覀示Ｐ
祭	祭示Ｊ
祭	祭示Ｚ
祯	礻卜贝
祷	礻丰寸
祸	礻口内
祺	礻其Ｑ
禀	亠囗示
禁	林示Ｊ
禄	礻彐水
禅	礻丷十
禊	礻刀大
福	礻畐Ｆ
禚	礻<美上>灬
禧	礻吉口
禳	礻衣口
禹	丿虫冂
禺	甲冂一
离	文凵冂
禽	人文冂
禾	禾ＨＥ
秀	禾乃Ｘ
私	禾厶Ｓ
秃	禾几Ｔ
秆	禾干Ｇ
秉	禾彐Ｂ
秋	禾火Ｑ
种	禾口丨
科	禾斗Ｋ
秒	禾少Ｍ
秕	禾比Ｂ
秘	禾心丿
租	禾且Ｚ
秣	禾末Ｍ
秤	禾干丷
秦	<春上>禾Ｑ
秧	禾央Ｙ
秩	禾失Ｚ
秫	禾木丶
秭	禾丿Ｓ
积	禾口八
称	禾刀小
秸	禾吉Ｊ
移	禾夕夕
秽	禾山夕
稀	禾乂巾
稂	禾丶艮
稃	禾爫子
稆	禾口口
程	禾口王
稍	禾Ｍ冃
税	禾丷儿
稔	禾亽心
稗	禾卑卑
稚	禾隹Ｚ
稞	禾日木
稠	禾冂土
稣	鱼禾Ｓ
稳	禾刀心
稷	禾田夂
稹	禾十八
稻	禾爫臼
稼	禾宀豕
稽	禾丶日
稿	禾高Ｇ
穆	禾白彡
穑	禾十囗
穗	禾士心
穰	禾衣口
穴	穴ＸＥ
究	穴九Ｊ
穷	穴力Ｑ
穸	穴夕Ｘ
穹	穴弓Ｑ
空	穴工Ｋ
穿	穴一才
窀	穴七凵
突	穴大丶
窃	穴七刀
窄	穴乍Ｚ
窈	穴幺力
窍	穴工丂
窑	穴缶Ｙ
窒	穴一土
窕	穴ＫＫ
窖	穴告Ｊ
窗	穴白夂
窘	穴丿口
窜	穴口丨
窝	穴口内
窟	穴尸出
窠	穴日木
窥	穴夫见
窦	穴十头
窨	穴立日
窬	穴亼前
窭	穴米女
窳	穴瓜瓜
窿	穴阝龶
立	立ＬＩ
竖	刂又立
站	立占占
竞	立口儿
竟	竟ＪＧ
章	章ＺＧ
竣	立厶夂
童	立里Ｔ
竦	立木口
竭	立日勹
端	立山皿
竹	竹ＺＵ
竺	竹二Ｚ
竽	竹于Ｙ
竿	竹干Ｇ
笃	竹马Ｄ
笄	竹一廾
笆	竹巴Ｂ
笈	竹及Ｊ
笊	竹爪Ｚ
笋	竹彐丿
笏	竹勹彳
笑	竹丿大
笔	竹毛Ｂ
笕	竹见Ｊ
笙	竹丿龶
笛	竹由Ｄ
笞	竹厶口
笠	竹立Ｌ
笤	竹召Ｔ
笥	竹亅口
符	竹亻寸
笨	竹木一
笪	竹日一
笫	竹Ｓ丿
第	竹弓丿
笮	竹乍Ｚ
笱	竹勹口
笳	竹加Ｊ
笸	竹匚口
笺	竹一戈
笼	竹龙Ｌ
笾	竹力辶
筅	竹牛儿
筇	竹工阝
等	竹土寸
筋	竹月力
筌	竹全Ｑ
筏	竹亻戈
筐	竹匚王
筑	竹工几
筒	竹冂一
答	竹亼口
策	竹木冂
筘	竹扌口
筚	竹比十
筛	竹刂巾
筝	竹刀亅
筠	竹土勹
筢	竹扌巴
筮	竹工人
筱	竹亻攵
筲	竹Ｍ冃
筵	竹丿廴
筷	竹忄夬
筹	竹丰寸
筻	竹丈日
签	竹亼兴
简	竹门日
箅	竹田丌
箍	竹扌匚
箐	竹青Ｑ
箔	竹氵白
箕	竹其Ｊ
算	竹目廾
箜	竹穴工
管	竹宀官
箢	竹夕㔾
箦	竹龶贝
箧	竹匚夫
箨	竹扌干
箩	竹罒夕
箪	竹丷十
箫	竹彐川
箬	竹厂口
箭	竹首前
箱	竹木目
箴	竹戊一
箸	竹者Ｚ
篁	竹白王
篆	竹彑豕
篇	竹户冊
篌	竹亻矢
篑	竹贵Ｋ
篓	竹米女
篙	竹高Ｇ
篚	竹匚非
篝	竹井冂
篡	竹目厶
篥	竹覀木
篦	竹白比
篪	竹厂几
篮	竹刂皿
篱	竹文冂
篷	竹夂辶
篼	竹白儿
篾	竹罒戊
簇	竹族矢
簋	竹艮皿
簌	竹木欠
簏	竹鹿比
簖	竹乚斤
簟	竹覀十
簧	竹龷八
簪	竹旡日
簸	竹其皮
簿	竹氵寸
籀	竹扌田
籁	竹木负
籍	竹耒日
米	米ＭＩ
籴	丿丶米
类	米大Ｌ
籼	米山Ｘ
籽	米子Ｚ
粉	米分Ｆ
粑	米巴Ｂ
粒	米立Ｌ
粕	米白Ｐ
粗	米且Ｃ
粘	米占占
粜	出米Ｔ
粝	米厂亅
粞	米西Ｘ
粟	覀米Ｓ
粢	冫欠米
粤	白米丂
粥	弓米弓
粪	米龷八
粮	米丶艮
粱	氵刀米
粲	卜又米
粳	米丈日
粹	米亠十
粼	米夕巛
粽	米宀示
精	米青Ｊ
糁	米厶彡
糅	米龴木
糇	米尸矢
糈	米乛冃
糊	米古月
糌	米卜日
糍	米首幺
糕	米<美上>灬
糖	米广口
糗	米丿大
糙	米告辶
糜	广林米
糟	米西日
糠	米广水
糨	米弓虽
糯	米雨皿
系	丿幺小
紊	文幺小
素	龶幺小
索	十冖小
紧	刂又小
紫	止匕小
累	田幺小
絮	女口小
絷	执执小
綦	其幺小
綮	户攵小
縻	广林小
繁	人攵小
繇	爫缶小
纂	竹目小
纛	龶小小
纠	纟丩Ｊ
纡	纟于Ｙ
红	纟工Ｈ
纣	纟寸Ｚ
纤	纟千Ｘ
纤	纟千Ｑ
纥	纟人乙
约	纟勹丶
级	纟及Ｊ
纨	纟九丶
纩	纟广Ｋ
纪	纟己Ｊ
纫	纟刀丶
纬	纟二卩
纭	纟云Ｙ
纯	纟七凵
纰	纟比Ｐ
纱	纟少Ｓ
纲	纟冂乂
纳	纟内Ｎ
纵	纟人人
纶	纟人匕
纷	纟分Ｆ
纸	纟Ｃ七
纹	纟文Ｗ
纺	纟方Ｆ
纽	纟丑Ｎ
纾	纟龴丁
线	纟一戈
绀	纟廿一
绁	纟世Ｘ
绂	纟犮Ｆ
练	纟七小
组	纟且Ｚ
绅	纟日丨
细	纟田Ｘ
织	纟口八
终	纟夂冫
绉	纟刀彐
绊	纟半Ｂ
绋	纟弓刂
绌	纟出Ｃ
绍	纟召Ｓ
绎	纟又干
经	纟又工
绐	纟厶口
绑	纟丰阝
绒	纟戈厂
结	纟吉Ｊ
绔	纟大Ｓ
绕	纟戈儿
绗	纟彳亍
绘	纟人云
给	纟亼口
绚	纟勹日
绛	纟夂舛
络	纟各Ｌ
绝	纟刀巴
绞	纟亠父
统	纟充儿
绠	纟丈日
绡	纟Ｍ冃
绢	纟口冃
绣	纟禾乃
绥	纟爫女
绦	纟夂朩
继	纟米乚
绨	纟丷弓
绩	纟龶贝
绪	纟者Ｘ
绫	纟土夂
续	纟十头
绮	纟大可
绯	纟非Ｆ
绰	纟卜十
绱	纟尚Ｓ
绲	纟日比
绳	纟口乚
维	纟隹Ｗ
绵	纟白巾
绶	纟受Ｓ
绷	纟月月
绸	纟冂土
绺	纟卜口
绻	纟龹㔾
综	纟宀示
绽	纟宀止
绾	纟宀官
绿	纟彐水
缀	纟又又
缁	纟巛田
缂	纟革Ｋ
缃	纟木目
缄	纟戊一
缅	纟丆罒
缆	纟Ｋ见
缇	纟日止
缈	纟目少
缉	纟口耳
缌	纟田心
缎	纟Ｅ殳
缑	纟尸矢
缒	纟追辶
缓	纟爫又
缔	纟旁巾
缕	纟米女
编	纟户冊
缗	纟巳日
缘	纟彑豕
缙	纟亚日
缚	纟甫寸
缛	纟厂寸
缜	纟十八
缝	纟夂辶
缟	纟高Ｇ
缠	纟广里
缡	纟文冂
缢	纟首皿
缣	纟首兼
缤	纟穴丘
缥	纟覀示
缦	纟日又
缧	纟田小
缨	纟贝女
缩	纟宀日
缪	纟羽彡
缫	纟巛木
缬	纟吉页
缭	纟大小
缮	纟羊口
缯	纟丷日
缰	纟一一
缱	纟虫辶
缲	纟口木
缳	纟罒ｒ
缴	纟白攵
缵	纟牛贝
缶	缶ＦＵ
缸	缶工Ｇ
缺	缶夬Ｑ
罂	贝贝缶
罄	声殳缶
罅	缶虍丁
罐	缶艹隹
网	冂乂乂
罔	冂首亡
罕	㓁干Ｈ
罗	罒夕Ｌ
罘	罒不Ｆ
罚	罒讠刂
罟	罒古Ｇ
罡	罒一止
罢	罒土厶
罨	罒大乚
罩	罒卜十
罪	罒非Ｚ
置	罒十且
罱	罒Ｍ首
署	罒者Ｓ
罴	罒土灬
罹	罒忄隹
罾	罒丷日
羁	罒革马
羊	羊ＹＧ
羌	羊乚Ｑ
美	<美上>大Ｍ
羔	<美上>灬Ｇ
羚	羊亽龴
羝	羊Ｃ七
羞	羊丑Ｘ
羟	羊又工
羡	<美上>冫欠
群	彐丿羊
羧	羊厶夂
羯	羊日勹
羰	羊山火
羲	<美上>丂戈
羸	赢赢羊
羹	<美上>灬大
羼	尸羊羊
羽	羽ＹＵ
羿	羽廾Ｙ
翁	八厶羽
翅	十又羽
翊	立羽Ｙ
翌	羽立Ｙ
翎	亽龴羽
翔	羊羽Ｘ
翕	亼口羽
翘	戈儿羽
翟	羽隹Ｚ
翟	羽隹Ｄ
翠	羽亠十
翡	非羽Ｆ
翥	者羽Ｚ
翦	首前羽
翩	户冊羽
翮	一冂羽
翰	十十羽
翱	白十羽
翳	匚殳羽
翻	丿田羽
翼	羽田八
耀	Ｍ儿隹
老	耂匕Ｌ
考	耂丂Ｋ
耄	耂匕毛
者	者ＺＥ
耆	耂匕日
耋	耂匕土
而	丆皿Ｅ
耍	丆皿女
耐	丆皿寸
耒	耒ＬＩ
耔	耒子Ｚ
耕	耒井Ｇ
耖	耒少Ｃ
耗	耒毛Ｈ
耘	耒云Ｙ
耙	耒巴Ｂ
耙	耒巴Ｐ
耜	耒官Ｓ
耠	耒亼口
耢	耒营力
耥	耒尚Ｔ
耦	耒甲冂
耧	耒米女
耨	耒厂寸
耩	耒井冂
耪	耒旁方
耱	耒广石
耳	耳ＥＲ
耵	耳丁Ｄ
耶	耳阝Ｙ
耷	大耳Ｄ
耸	人人耳
耻	耳止Ｃ
耽	耳巾乚
耿	耳火Ｇ
聂	耳又又
聃	耳冂土
聆	耳亽龴
聊	耳Ｇ卩
聋	龙耳Ｌ
职	耳口八
聍	耳宁Ｎ
聒	耳舌Ｇ
联	耳丷大
聘	耳由丂
聚	耳又乑
聩	耳贵Ｋ
聪	耳丷心
聱	敖耳Ａ
聿	彐干Ｙ
肃	彐川Ｓ
肄	匕矢干
肆	Ｅ厶干
肇	户攵干
肉	内人Ｒ
肋	月力Ｌ
肌	月几Ｊ
肓	亡冃Ｈ
肖	Ｍ冃Ｘ
肘	月寸Ｚ
肚	月土Ｄ
肛	月工Ｇ
肝	月干Ｇ
肟	月二Ｓ
肠	月Ｊ彳
股	月殳Ｇ
肢	月十又
肤	月夫Ｆ
肥	月巴Ｆ
肩	户冃Ｊ
肪	月方Ｆ
肫	月七凵
肭	月内Ｎ
肮	月亠几
肯	止冃Ｋ
肱	月厂厶
育	充冃Ｙ
肴	乂厂冃
肷	月欠Ｑ
肺	月一巾
肼	月井Ｊ
肽	月大丶
肾	刂又冃
肿	月口丨
胀	月长Ｚ
胁	月力八
胂	月日丨
胃	田冃Ｗ
胄	由冃Ｚ
胆	月日一
背	丬匕冃
胍	月瓜Ｇ
胎	月厶口
胖	月半Ｐ
胗	月人彡
胙	月乍Ｚ
胚	月不一
胛	月甲Ｊ
胜	月丿龶
胝	月Ｃ七
胞	月包Ｂ
胡	古月Ｈ
胤	儿幺月
胥	乛止冃
胧	月龙Ｌ
胨	月七小
胩	月卜下
胪	月卜尸
胫	月又工
胬	女又内
胭	月囗大
胯	月大Ｓ
胰	月大弓
胱	月Ｍ儿
胲	月亥Ｈ
胳	月各Ｇ
胴	月冂一
胶	月亠父
胸	月勹乂
胺	月安安
胼	月首廾
能	厶冃匕
脂	月匕日
脆	月刀㔾
脉	月丶水
脊	ＫＫ月
脍	月人云
脎	月乂朩
脏	月广土
脐	月文刂
脑	月文凵
脒	月米Ｍ
脓	月巾ｒ
脔	亦内人
脖	月十子
脘	月宀元
脚	月土卩
脞	月人土
脬	月爫子
脯	月甫Ｐ
脯	月甫Ｆ
脱	月丷儿
脲	月尸水
脶	月口内
脸	月亼兴
脾	月卑卑
腆	月冂八
腈	月青Ｊ
腊	月龷日
腋	月亠夂
腌	月大乚
腐	广亻内
腑	月广寸
腓	月非Ｆ
腔	月穴工
腕	月宀㔾
腙	月宀示
腚	月宀止
腠	月<春上>大
腥	月日龶
腧	月亼前
腩	月Ｍ首
腭	月口Ｓ
腮	月田心
腰	月覀女
腱	月彐廴
腴	月臼人
腹	月人夂
腺	月白水
腻	月弋二
腼	月丆罒
腽	月日皿
腾	月龹马
腿	月艮辶
膀	月旁方
膂	族丿冃
膈	月一冂
膊	月甫寸
膏	高月Ｇ
膑	月穴丘
膘	月覀示
膛	月尚土
膜	月莫Ｍ
膝	月木氺
膦	月米舛
膨	月吉彡
膳	月羊口
膺	广亻冃
膻	月亠一
臀	尸殳冃
臂	尸辛冃
臃	月亠隹
臆	月立心
臊	月口木
臌	月十又
臣	匚丨尸
臧	戊乚丆
自	丿目Ｚ
臬	丿目木
臭	丿目大
至	一厶土
致	一土攵
臻	一土禾
臼	臼ＪＵ
臾	臼人Ｙ
舀	爫臼Ｙ
舁	臼廾Ｙ
舂	<春上>臼Ｃ
舄	臼勹灬
舅	臼田力
舆	臼车八
舌	舌ＳＥ
舍	亼古Ｓ
舐	舌Ｃ七
舒	亼古丁
舔	舌一小
舛	夕舛Ｃ
舜	爫夕舛
舞	人夕舛
舟	舟ＺＵ
舢	舟山Ｓ
舣	舟丶乂
航	舟亠几
舫	舟方Ｆ
般	舟殳Ｂ
舭	舟比Ｂ
舯	舟口丨
舰	舟见Ｊ
舱	舟仓Ｃ
舳	舟由Ｚ
舴	舟乍Ｚ
舵	舟宀匕
舶	舟白Ｂ
舷	舟玄Ｘ
舸	舟可Ｇ
船	舟几口
舻	舟卜尸
舾	舟西Ｘ
艄	舟Ｍ冃
艇	舟壬廴
艉	舟尸毛
艋	舟子皿
艏	舟首目
艘	舟叟Ｓ
艚	舟西日
艟	舟立里
艨	舟营豕
艮	艮ＧＮ
良	丶艮Ｌ
艰	又艮Ｊ
色	刀巴Ｓ
艳	丰刀巴
艴	弓刂巴
艺	艹乙Ｙ
艽	艹九Ｊ
艾	艹乂Ａ
艾	艹乂Ｙ
艿	艹乃Ｎ
节	艹卩Ｊ
芄	艹九丶
芈	丨一干
芊	艹千Ｑ
芋	艹于Ｙ
芍	艹勹丶
芎	艹弓Ｘ
芏	艹土Ｄ
芑	艹己Ｑ
芒	艹亡Ｍ
芗	艹丝丿
芘	艹比Ｂ
芙	艹夫Ｆ
芜	艹干乚
芝	艹之Ｚ
芟	艹殳Ｓ
芡	艹欠Ｑ
芤	艹子乚
芥	艹人刂
芦	艹户Ｌ
芨	艹及Ｊ
芩	艹亽乛
芪	艹Ｃ七
芫	艹元Ｙ
芬	艹分Ｆ
芭	艹巴Ｂ
芮	艹内Ｒ
芯	艹心Ｘ
芰	艹十又
花	艹亻匕
芳	艹方Ｆ
芴	艹勹彳
芷	艹止Ｚ
芸	艹云Ｙ
芹	艹斤Ｑ
芽	艹一才
芾	艹一巾
苁	艹人人
苄	艹亠卜
苇	艹二卩
苈	艹厂力
苊	艹厂㔾
苋	艹见Ｘ
苌	艹长Ｃ
苍	艹仓Ｃ
苎	萱一Ｚ
苏	艹力八
苑	艹夕㔾
苒	艹冂土
苓	艹亽龴
苔	艹厶口
苕	艹召Ｓ
苗	艹田Ｍ
苘	艹冂口
苛	艹可Ｋ
苜	艹目Ｍ
苞	艹包Ｂ
苟	艹勹口
苠	艹巳七
苡	艹以Ｙ
苣	艹匚尸
苤	艹不一
若	艹厂口
苦	艹古Ｋ
苫	艹占占
苯	艹木一
英	艹央Ｙ
苴	艹且Ｊ
苷	艹廿一
苹	艹干丷
苻	艹亻寸
茁	艹出Ｚ
茂	艹戊Ｍ
范	落㔾Ｆ
茄	艹加Ｑ
茄	艹加Ｊ
茅	艹龴才
茆	艹Ｇ卩
茈	艹止匕
茉	艹末Ｍ
茌	艹亻士
茎	艹又工
茏	艹龙Ｌ
茑	艹鸟Ｎ
茔	营土Ｙ
茕	营乙十
茗	艹夕口
茚	艹Ｅ卩
茛	艹艮Ｇ
茜	艹西Ｘ
茜	艹西Ｑ
茧	艹虫Ｊ
茨	艹冫欠
茫	落亡Ｍ
茬	艹Ｐ土
茭	艹亠父
茯	艹亻大
茱	艹朱Ｚ
茳	落工Ｊ
茴	艹囗口
茵	艹囗大
茶	艹人朩
茸	艹耳Ｒ
茹	艹女口
茺	艹充儿
茼	艹冂一
荀	艹勹日
荃	艹全Ｑ
荆	艹廾刂
荇	艹彳亍
草	艹日十
荏	艹亻壬
荐	艹Ｐ子
荑	艹大弓
荒	艹亡川
荔	艹力力
荚	艹夫丷
荛	艹戈儿
荜	艹比十
荞	艹丿刂
荟	艹人云
荠	艹文刂
荡	落Ｊ彳
荣	营木Ｒ
荤	营车Ｈ
荥	营水Ｘ
荥	营水Ｙ
荦	营牛Ｌ
荧	营火Ｙ
荨	艹彐寸
荩	艹尺冫
荪	艹子小
荫	艹阝月
荬	艹乛头
荭	艹纟工
荮	艹纟寸
药	艹纟勹
荷	艹亻可
荸	艹十子
荻	艹犭火
荼	艹余Ｔ
荽	艹爫女
莅	艹亻立
莆	艹甫Ｐ
莉	艹禾刂
莎	落少Ｓ
莒	艹口口
莓	艹人母
莘	艹辛Ｓ
莘	艹辛Ｘ
莛	艹壬廴
莜	艹亻攵
莞	萱元Ｗ
莞	萱元Ｇ
莠	艹禾乃
莨	艹丶艮
莩	艹爫子
莪	艹手戈
莫	莫ＭＯ
莰	艹土欠
莱	艹未丷
莲	艹车辶
莳	艹日寸
莴	艹口内
莶	艹亼兴
获	艹犭大
莸	艹犭尢
莹	营王丶
莺	营鸟Ｙ
莼	艹纟七
莽	艹大廾
菀	萱夕㔾
菁	艹青Ｊ
菅	萱官Ｊ
菇	艹女古
菊	艹勹米
菌	艹囗禾
菏	落可Ｈ
菔	艹月又
菖	艹日日
菘	艹木厶
菜	艹爫木
菝	艹扌犮
菟	艹兔Ｔ
菠	落皮Ｂ
菡	艹乛凵
菥	艹木斤
菩	艹立口
菪	萱石Ｄ
菰	艹子瓜
菱	艹土夂
菲	艹非Ｆ
菹	落且Ｚ
菽	艹小又
萁	艹其Ｑ
萃	艹亠十
萄	艹勹缶
萆	艹卑卑
萋	艹十女
萌	艹日月
萍	落干丷
萎	艹禾女
萏	艹刀臼
萑	艹隹Ｈ
萘	艹大示
萜	艹巾占
萝	艹罒夕
萤	营虫Ｙ
营	营口口
萦	营幺小
萧	艹彐川
萨	艹阝丿
萱	萱一一
萸	艹臼人
萼	艹口Ｓ
落	落各Ｌ
葆	艹亻木
葑	艹圭寸
著	艹者Ｚ
葙	艹木目
葚	艹其乚
葛	艹勹乚
葜	艹丰大
葡	艹勹甫
董	艹千里
葩	艹白巴
葫	艹古月
葬	艹歹廾
葭	艹丨又
葱	艹勹心
葳	艹戊一
葵	艹癶大
葶	艹亮丁
葸	艹田心
葺	艹口耳
蒂	艹旁巾
蒇	艹戊贝
蒈	艹比白
蒉	艹贵Ｋ
蒋	艹丬寸
蒌	艹米女
蒎	落厂ｒ
蒗	落丶艮
蒙	营二豕
蒜	艹示示
蒡	艹旁方
蒯	艹月刂
蒲	落甫Ｐ
蒴	艹屮月
蒸	艹乛灬
蒹	艹首兼
蒺	艹疒矢
蒽	艹囗心
蒿	艹高Ｈ
蓁	艹<春上>禾
蓄	艹玄田
蓉	萱谷Ｒ
蓊	艹八羽
蓍	艹耂日
蓐	艹厂寸
蓑	艹衣口
蓓	艹亻口
蓖	艹白比
蓝	艹刂皿
蓟	艹鱼刂
蓠	艹文冂
蓣	艹丁页
蓥	营金Ｙ
蓦	莫马Ｍ
蓬	艹夂辶
蓰	艹彳止
蓼	艹羽彡
蓿	萱亻日
蔌	艹木欠
蔑	艹罒戊
蔓	艹日又
蔗	艹广灬
蔚	艹尸寸
蔟	艹族矢
蔡	艹祭示
蔫	艹Ｓ灬
蔬	艹止川
蔷	艹十囗
蔸	艹白儿
蔹	艹兴攵
蔺	艹门隹
蔻	萱元卜
蔼	艹讠勹
蔽	艹巾攵
蕃	艹丿田
蕈	艹覀十
蕉	艹焦Ｊ
蕊	艹心心
蕖	落匚木
蕙	艹士心
蕞	艹耳又
蕤	艹豕丿
蕨	艹厂欠
蕲	艹十斤
蕴	艹纟皿
蕹	艹丿隹
蕺	艹耳戈
蕻	艹厶八
蕾	艹雨田
薄	落甫寸
薅	艹女寸
薇	艹微微
薏	艹立心
薛	艹追辛
薜	艹尸辛
薤	艹歹一
薨	艹歹匕
薪	艹亲斤
薮	艹女攵
薯	艹罒者
薰	艹千黑
薷	艹雨皿
薹	艹吉土
藁	艹高木
藉	艹耒日
藏	艹戊丆
藐	艹豸儿
藓	艹鱼羊
藕	艹耒冂
藜	艹禾氺
藤	艹月氺
藩	落丿田
藻	落氵木
藿	艹雨隹
蘅	艹彳亍
蘑	艹广石
蘖	艹追木
蘧	艹虍辶
蘩	艹人小
蘸	艹酉焦
蘼	艹广非
虎	虍几Ｈ
虏	虍力Ｌ
虐	虍ＥＮ
虑	虍心Ｌ
虔	虍文Ｑ
虚	虍业Ｘ
虞	虍口大
虢	爫寸几
虫	虫ＣＧ
虬	虫乚Ｑ
虮	虫几Ｊ
虱	乙丿虫
虹	虫工Ｈ
虹	虫工Ｊ
虺	一儿虫
虻	虫亡Ｍ
虼	虫人乙
虽	虽ＳＩ
虾	虫下Ｘ
虿	丆亅虫
蚀	饣虫Ｓ
蚁	虫丶乂
蚂	虫马Ｍ
蚊	虫文Ｗ
蚋	虫内Ｒ
蚌	虫丰Ｂ
蚍	虫比Ｐ
蚓	虫弓丨
蚕	一大虫
蚜	虫一才
蚝	虫毛Ｈ
蚣	虫八厶
蚤	又丶虫
蚧	虫人刂
蚨	虫夫Ｆ
蚩	屮一虫
蚪	虫斗Ｄ
蚬	虫见Ｘ
蚯	虫丘Ｑ
蚰	虫由Ｙ
蚱	虫乍Ｚ
蚴	虫幺力
蚶	虫廿一
蚺	虫冂土
蛀	虫主Ｚ
蛄	虫古Ｇ
蛆	虫且Ｑ
蛇	虫宀匕
蛉	虫亽龴
蛊	虫皿Ｇ
蛋	乛止虫
蛎	虫厂亅
蛏	虫又土
蛐	虫日刂
蛑	虫厶牛
蛔	虫囗口
蛘	虫羊Ｙ
蛙	虫圭Ｗ
蛛	虫朱Ｚ
蛞	虫舌Ｋ
蛟	虫亠父
蛤	虫亼口
蛩	工几虫
蛭	虫一土
蛮	亦虫Ｍ
蛰	执执虫
蛱	虫夫丷
蛲	虫戈儿
蛳	虫一巾
蛴	虫文刂
蛸	虫Ｍ冃
蛹	虫龴用
蛾	虫手戈
蜀	罒勹虫
蜂	虫夂丰
蜃	厂ｒ虫
蜇	扌斤虫
蜈	虫口大
蜉	虫爫子
蜊	虫禾刂
蜍	虫余Ｃ
蜒	虫丿廴
蜓	虫壬廴
蜕	虫丷儿
蜗	虫口内
蜘	虫矢口
蜚	非虫Ｆ
蜜	宀心虫
蜞	虫其Ｑ
蜡	虫龷日
蜢	虫子皿
蜣	虫羊乚
蜥	虫木斤
蜩	虫冂土
蜮	虫戈口
蜱	虫卑卑
蜴	虫日勹
蜷	虫龹㔾
蜻	虫青Ｑ
蜾	虫日木
蜿	虫宀㔾
蝇	虫口乚
蝈	虫囗王
蝉	虫丷十
蝌	虫禾斗
蝎	虫日勹
蝓	虫亼前
蝗	虫白王
蝙	虫户冊
蝠	虫畐Ｆ
蝣	虫族子
蝤	虫酋Ｑ
蝤	虫酋Ｙ
蝥	龴攵虫
蝮	虫人夂
蝰	虫大圭
蝴	虫古月
蝶	虫世木
蝻	虫Ｍ首
蝼	虫米女
蝽	虫<春上>日
蝾	虫营木
螂	虫丶阝
螃	虫旁方
螅	虫丿心
螈	虫厂小
螋	虫叟Ｓ
融	一冂虫
螗	虫广口
螟	虫冖八
螨	虫艹两
螫	土攵虫
螬	虫西日
螭	虫文冂
螯	敖虫Ａ
螳	虫尚土
螵	虫覀示
螺	虫田小
螽	夂虫虫
蟀	虫亠十
蟆	虫莫Ｍ
蟊	龴虫虫
蟋	虫丿心
蟑	虫章Ｚ
蟒	虫艹廾
蟛	虫吉彡
蟠	虫丿田
蟥	虫龷八
蟪	虫士心
蟮	虫羊口
蟹	刀刀虫
蟾	虫刀言
蠃	赢赢虫
蠊	虫广兼
蠓	虫营豕
蠕	虫雨皿
蠖	虫艹又
蠡	彑虫虫
蠢	<春上>虫虫
蠲	首皿勹
蠹	十虫虫
蠼	虫目又
血	丿皿Ｘ
衄	丿皿丑
衅	丿皿半
行	彳亍Ｘ
行	彳亍Ｈ
衍	彳氵亍
衔	彳钅亍
街	彳圭亍
衙	彳五亍
衡	彳刀亍
衢	彳目亍
衣	衣ＹＩ
补	衤卜Ｂ
表	龶ｒＢ
衩	衤又丶
衫	衤彡Ｓ
衬	衤寸Ｃ
衮	衣八厶
衰	衣口Ｓ
衲	衤内Ｎ
衷	衣口丨
衽	衤壬Ｒ
衾	亽乛衣
衿	衤亽乛
袁	土口ｒ
袂	衤夬Ｍ
袄	衤丿大
袅	鸟衣Ｎ
袈	加衣Ｊ
袋	代衣Ｄ
袍	衤包Ｐ
袒	衤日一
袖	衤由Ｘ
袜	衤末Ｗ
袢	衤半Ｐ
袤	衣龴才
被	衤皮Ｂ
袭	龙衣Ｘ
袱	衤大丶
袷	衤亼口
袼	衤各Ｇ
裁	十戈衣
裂	歹刂衣
装	丬士衣
裆	衤Ｍ彐
裉	衤艮Ｋ
裎	衤口王
裒	衣臼Ｐ
裔	衣冂八
裕	衤谷Ｙ
裘	氺丶衣
裙	衤彐口
裟	氵少衣
裢	衤车辶
裣	衤亼兴
裤	衤广车
裥	衤门日
裨	衤卑卑
裰	衤又又
裱	衤龶ｒ
裳	尚衣Ｓ
裴	非衣Ｐ
裸	衤日木
裹	衣日木
裼	衤日勹
裾	衤尸古
褂	衤圭卜
褊	衤户冊
褐	衤日勹
褒	衣亻口
褓	衤口木
褙	衤匕冃
褚	衤者Ｃ
褛	衤米女
褡	衤艹口
褥	衤厂寸
褪	衤艮辶
褫	衤厂几
褰	宀井衣
褴	衤Ｋ皿
褶	衤羽白
襁	衤弓虽
襄	衣口口
襞	尸辛衣
襟	衤林示
襦	衤雨皿
襻	衤木手
西	西ＸＩ
要	覀女Ｙ
覃	覀日十
覆	覀彳夂
见	见ＪＮ
见	见ＸＮ
观	又见Ｇ
规	夫见Ｇ
觅	爫见Ｍ
视	礻见Ｓ
觇	占占见
览	刂Ｋ见
觉	学见Ｊ
觊	山己见
觋	工人见
觌	十头见
觎	亼前见
觏	井冂见
觐	廿龶见
觑	虍业见
角	刀用Ｊ
觖	刀用夬
觚	刀用瓜
觜	止匕用
觞	刀用Ｊ
解	刀用牛
觥	刀用儿
触	刀用虫
觫	刀用木
觯	刀用十
觳	士用殳
言	言ＹＮ
訇	勹言Ｈ
訾	止匕言
詈	罒言Ｌ
詹	刀厂言
誉	兴八言
誊	龹言Ｔ
誓	扌斤言
謇	宀井言
警	艹攵言
譬	尸辛言
计	讠十Ｊ
订	讠丁Ｄ
讣	讠卜Ｆ
认	讠人Ｒ
讥	讠几Ｊ
讦	讠干Ｊ
讧	讠工Ｈ
讨	讠寸Ｔ
让	讠卜一
讪	讠山Ｓ
讫	讠人乙
训	讠川Ｘ
议	讠丶乂
讯	讠乙十
记	讠己Ｊ
讲	讠井Ｊ
讳	讠二卩
讴	讠匚乂
讵	讠匚尸
讶	讠一才
讷	讠内Ｎ
许	讠午Ｘ
讹	讠亻匕
论	讠人匕
讼	讠八厶
讽	讠风Ｆ
设	讠殳Ｓ
访	讠方Ｆ
诀	讠夬Ｊ
证	讠一止
诂	讠古Ｇ
诃	讠可Ｈ
评	讠干丷
诅	讠且Ｚ
识	讠口八
诈	讠乍Ｚ
诉	讠斤丶
诊	讠人彡
诋	讠Ｃ七
诌	讠刀彐
词	讠亅一
诎	讠出Ｑ
诏	讠召Ｚ
译	讠又干
诒	讠厶口
诓	讠匚王
诔	讠耒Ｌ
试	讠弋工
诖	讠圭Ｇ
诗	讠土寸
诘	讠吉Ｊ
诙	讠厂火
诚	讠戊亅
诛	讠朱Ｚ
诜	讠牛儿
话	讠舌Ｈ
诞	讠丿廴
诟	讠Ｆ口
诠	讠全Ｑ
诡	讠刀㔾
询	讠勹日
诣	讠匕日
诤	讠刀亅
该	讠亥Ｇ
详	讠羊Ｘ
诧	讠宀七
诨	讠冖车
诩	讠羽Ｘ
诫	讠戈廾
诬	讠工人
语	讠五口
诮	讠Ｍ冃
误	讠口大
诰	讠告Ｇ
诱	讠禾乃
诲	讠人母
诳	讠犭王
说	讠丷儿
诵	讠龴用
请	讠青Ｑ
诸	讠者Ｚ
诹	讠耳又
诺	讠艹口
读	讠十头
诼	讠豕丶
诽	讠非Ｆ
课	讠日木
诿	讠禾女
谀	讠臼人
谁	讠隹Ｓ
谂	讠亽心
调	讠冂土
谄	讠刀臼
谅	讠高小
谆	讠高子
谇	讠亠十
谈	讠火火
谊	讠宀且
谋	讠廿木
谌	讠其乚
谍	讠世木
谎	讠艹川
谏	讠木柬
谐	讠比白
谑	讠虍Ｅ
谒	讠日勹
谓	讠田冃
谔	讠口Ｓ
谕	讠亼前
谖	讠爫又
谗	讠刀冫
谙	讠立日
谚	讠立彡
谛	讠旁巾
谜	讠米辶
谝	讠户冊
谟	讠莫Ｍ
谠	讠尚儿
谡	讠田夂
谢	讠身寸
谣	讠爫缶
谤	讠旁方
谥	讠首皿
谦	讠首兼
谧	讠心皿
谨	讠廿龶
谩	讠日又
谪	讠啇Ｚ
谫	讠首刀
谬	讠羽彡
谭	讠覀十
谮	讠旡日
谯	讠焦Ｑ
谰	讠门木
谱	讠首日
谲	讠龴冂
谳	讠大丶
谴	讠虫辶
谵	讠刀言
谶	讠人戈
谷	谷ＧＵ
豁	宀口谷
豆	一口首
豇	一首工
豉	一首又
豌	一首㔾
豕	豕ＳＩ
豚	月豕Ｔ
象	象ＸＧ
豢	龹豕Ｈ
豪	亮豕Ｈ
豫	龴丁象
豳	山豕豕
豸	豸ＺＩ
豹	豸勹丶
豺	豸才Ｃ
貂	豸召Ｄ
貅	豸亻木
貉	豸各Ｈ
貊	豸丆日
貌	豸白儿
貔	豸白比
貘	豸莫Ｍ
贝	贝ＢＩ
贞	卜贝Ｚ
负	负ＦＵ
贡	工贝Ｇ
财	贝才Ｃ
责	龶贝Ｚ
贤	刂又贝
败	贝攵Ｂ
账	贝长Ｚ
货	亻匕贝
质	厂十贝
贩	贝反反
贪	亽乛贝
贫	分贝Ｐ
贬	贝丿之
购	贝勹厶
贮	贝宀一
贯	毌贝Ｇ
贰	弋二贝
贱	贝一戈
贲	十艹贝
贳	世贝Ｓ
贴	贝占占
贵	贵ＧＩ
贶	贝口儿
贷	代贝Ｄ
贸	Ｃ刀贝
费	弓刂贝
贺	加贝Ｈ
贻	贝厶口
贼	贝戈厂
贽	执执贝
贾	覀贝Ｊ
贾	覀贝Ｇ
贿	贝厂冃
赀	止匕贝
赁	亻壬贝
赂	贝各Ｌ
赃	贝广土
资	冫欠贝
赅	贝亥Ｇ
赆	贝尺冫
赇	贝氺丶
赈	贝厂ｒ
赉	未丷贝
赊	贝人示
赋	贝一弋
赌	贝者Ｄ
赍	十人贝
赎	贝十头
赏	尚贝Ｓ
赐	贝日勹
赓	广彐贝
赔	贝立口
赕	贝火火
赖	木口负
赘	敖贝Ｚ
赙	贝甫寸
赚	贝首兼
赛	宀井贝
赜	匚龶贝
赝	厂亻贝
赞	牛牛贝
赠	贝丷日
赡	贝刀言
赢	赢赢贝
赣	章夂贝
赤	土亦Ｃ
赦	土亦攵
赧	土亦又
赫	土亦亦
赭	土亦者
走	走ＺＵ
赳	走丩Ｊ
赴	走卜Ｆ
赵	走乂Ｚ
赶	走干Ｇ
起	走己Ｑ
趁	走人彡
趄	走且Ｑ
趄	走且Ｊ
超	走召Ｃ
越	走戈乚
趋	走刀彐
趑	走冫欠
趔	走歹刂
趟	走尚Ｔ
趣	走耳又
趱	走牛牛
足	足ＺＵ
趴	足八Ｐ
趵	足勹丶
趸	丆亅足
趺	足夫Ｆ
趼	足一廾
趾	足止Ｚ
趿	足及Ｔ
跃	足丿大
跄	足仓Ｑ
跆	足厶口
跋	足犮Ｂ
跌	足失Ｄ
跎	足宀匕
跏	足加Ｊ
跑	足包Ｐ
跖	足石Ｚ
跗	足亻寸
跚	足册Ｓ
跛	足皮Ｂ
距	足匚尸
跞	足Ｃ小
跟	足艮Ｇ
跣	足牛儿
跤	足亠父
跨	足大Ｓ
跪	足刀㔾
跬	足圭Ｋ
路	足各Ｌ
跳	足ＫＫ
践	足一戈
跷	足戈儿
跸	足比十
跹	足千辶
跺	足几木
跻	足文刂
跽	足己心
踅	扌斤足
踉	足丶艮
踊	足龴用
踌	足丰寸
踏	足水日
踔	足卜十
踝	足日木
踞	足尸古
踟	足矢口
踢	足日勹
踣	足立口
踩	足爫木
踪	足宀示
踬	足厂贝
踮	足广占
踯	足丷阝
踱	足广又
踵	足千里
踹	足山皿
踺	足彐廴
踽	足丿冂
蹀	足世木
蹁	足户冊
蹂	足龴木
蹄	足旁巾
蹇	宀井足
蹈	足爫臼
蹉	足羊工
蹊	足爫大
蹋	足日羽
蹑	足耳又
蹒	足艹两
蹙	戊卜足
蹦	足山月
蹩	丷攵足
蹬	足癶首
蹭	足丷日
蹯	足丿田
蹰	足厂寸
蹲	足酋寸
蹴	足尢丶
蹶	足厂欠
蹼	足业丶
蹿	足穴丨
躁	足口木
躅	足罒勹
躇	足艹者
躏	足艹门
躐	足巛鼠
躔	足广土
躜	足牛贝
躞	足火又
身	身ＳＮ
躬	身弓Ｇ
躯	身匚乂
躲	身几木
躺	身尚Ｔ
车	车ＣＥ
车	车ＪＵ
轧	车乚Ｙ
轧	车乚Ｚ
轨	车九Ｇ
轩	车干Ｘ
轫	车刀丶
转	车二龴
轭	车厂㔾
轮	车人匕
软	车欠Ｒ
轰	车又又
轱	车古Ｇ
轲	车可Ｋ
轳	车卜尸
轴	车由Ｚ
轵	车口八
轶	车失Ｙ
轷	车丿丁
轸	车人彡
轹	车Ｃ小
轺	车召Ｙ
轻	车又工
轼	车弋工
载	十戈车
轾	车一土
轿	车丿刂
辁	车全Ｑ
辂	车各Ｌ
较	车亠父
辄	车耳乚
辅	车甫Ｆ
辆	车两Ｌ
辇	夫夫车
辈	非车Ｂ
辉	Ｍ儿车
辊	车日比
辋	车冂首
辍	车又又
辎	车巛田
辏	车<春上>大
辐	车畐Ｆ
辑	车口耳
输	车亼前
辔	纟纟口
辕	车土ｒ
辖	车宀口
辗	车尸ｒ
辘	车鹿比
辙	车充攵
辚	车米舛
辛	辛ＸＮ
辜	古辛Ｇ
辞	舌辛Ｃ
辟	尸口辛
辣	辛木口
辨	辛刂辛
辩	辛讠辛
辫	辛纟辛
辰	厂ｒＣ
辱	厂ｒ寸
边	力辶Ｂ
辽	乛亅辶
达	大辶Ｄ
迁	千辶Ｑ
迂	于辶Ｙ
迄	人乙辶
迅	乙十辶
过	寸辶Ｇ
迈	丆亅辶
迎	Ｃ卩辶
运	云辶Ｙ
近	斤辶Ｊ
迓	一才辶
返	反反辶
迕	午辶Ｗ
还	不辶Ｈ
这	文辶Ｚ
进	井辶Ｊ
远	元辶Ｙ
违	二卩辶
连	车辶Ｌ
迟	尺辶Ｃ
迢	召辶Ｔ
迤	人也辶
迥	冂口辶
迦	加辶Ｊ
迨	厶口辶
迩	刀小辶
迪	由辶Ｄ
迫	白辶Ｐ
迭	失辶Ｄ
迮	乍辶Ｚ
述	木丶辶
迳	又工辶
迷	米辶Ｍ
迸	首廾辶
迹	亦辶Ｊ
追	追辶Ｚ
退	艮辶Ｔ
送	丷大辶
适	舌辶Ｓ
逃	ＫＫ辶
逄	夂舛辶
逅	Ｆ口辶
逆	丷屮辶
选	牛儿辶
逊	子小辶
逋	甫辶Ｂ
逍	Ｍ冃辶
透	禾乃辶
逐	豕辶Ｚ
逑	氺丶辶
递	丷弓辶
途	余辶Ｔ
逖	犭火辶
逗	一口辶
通	龴用辶
逛	犭王辶
逝	扌斤辶
逞	口王辶
速	木口辶
造	告辶Ｚ
逡	厶八辶
逢	夂丰辶
逦	一冂辶
逭	宀官辶
逮	彐水辶
逯	彐水辶
逵	土八辶
逶	禾女辶
逸	兔辶Ｙ
逻	罒夕辶
逼	畐辶Ｂ
逾	亼前辶
遁	厂十辶
遂	首豕辶
遄	山丆辶
遇	甲冂辶
遍	户冊辶
遏	日勹辶
遐	尸尸辶
遑	白王辶
遒	酋辶Ｑ
道	首丿辶
遗	贵辶Ｙ
遘	井冂辶
遛	Ｃ刀辶
遢	日羽辶
遣	虫官辶
遥	爫缶辶
遨	敖辶Ａ
遭	西日辶
遮	广廿辶
遴	米夕辶
遵	酋寸辶
遽	虍豕辶
避	尸辛辶
邀	白攵辶
邂	刀刀辶
邃	穴首辶
邈	豸白辶
邋	巛囗辶
邑	口巴Ｙ
邓	又阝Ｄ
邕	巛口巴
邗	干阝Ｈ
邙	亡阝Ｍ
邛	工阝Ｑ
邝	广阝Ｋ
邡	方阝Ｆ
邢	一廾阝
那	月阝Ｎ
邦	丰阝Ｂ
邪	一才阝
邬	乌阝Ｗ
邮	由阝Ｙ
邯	廿一阝
邰	厶口阝
邱	丘阝Ｑ
邳	不一阝
邴	一内阝
邵	召阝Ｓ
邶	丬匕阝
邸	Ｃ七阝
邹	刀彐阝
邺	业阝Ｙ
邻	亽龴阝
邾	朱阝Ｚ
郁	厂冃阝
郄	乂厂阝
郅	一土阝
郇	勹日阝
郊	亠父阝
郎	丶艮阝
郏	夫丷阝
郐	人云阝
郑	丷大阝
郓	冖车阝
郗	乂厂阝
郛	爫子阝
郜	告阝Ｇ
郝	土亦阝
郡	彐丿阝
郢	口王阝
郦	一冂阝
郧	口贝阝
部	立口阝
郫	卑卑阝
郭	高子阝
郯	火火阝
郴	林阝Ｃ
郸	丷十阝
都	者阝Ｄ
郾	匚日阝
鄂	口Ｓ阝
鄄	覀土阝
鄙	口囗阝
鄞	廿龶阝
鄢	一灬阝
鄣	章阝Ｚ
鄯	羊口阝
鄱	丿田阝
鄹	耳乑阝
酃	雨口阝
酆	丰首阝
酉	酉ＹＵ
酊	酉丁Ｄ
酋	酋ＱＵ
酌	酉勹丶
配	酉己Ｐ
酎	酉寸Ｚ
酏	酉也Ｙ
酐	酉干Ｇ
酒	氵酉Ｊ
酗	酉乂凵
酚	酉分Ｆ
酝	酉云Ｙ
酞	酉大丶
酡	酉宀匕
酢	酉乍Ｚ
酣	酉廿一
酤	酉古Ｇ
酥	酉禾Ｓ
酩	酉夕口
酪	酉各Ｌ
酬	酉州Ｃ
酮	酉冂一
酯	酉匕日
酰	酉牛儿
酱	丬夕酉
酲	酉口王
酴	酉余Ｔ
酵	酉耂子
酶	酉人母
酷	酉告Ｋ
酸	酉厶夂
酹	酉爫寸
酽	酉亚丿
酾	酉一冂
酿	酉丶艮
醅	酉立口
醇	酉高子
醉	酉亠十
醋	酉龷日
醌	酉日比
醍	酉日止
醐	酉古月
醑	酉乛冃
醒	酉日龶
醚	酉米辶
醛	酉艹全
醢	酉厂皿
醪	酉羽彡
醭	酉业丶
醮	酉焦Ｊ
醯	酉充皿
醴	酉日首
醵	酉虍豕
醺	酉千黑
采	爫木Ｃ
釉	丿米由
释	丿米干
里	里ＬＩ
重	千里Ｃ
重	千里Ｚ
野	里龴丁
量	日一里
金	金ＪＮ
釜	父干首
鉴	刂Ｋ金
銎	工几金
銮	亦金Ｌ
鋈	氵丿金
錾	车斤金
鍪	龴攵金
鎏	氵充金
鏊	敖金Ａ
鏖	鹿比金
鐾	尸辛金
鑫	金金金
钆	钅乚Ｇ
钇	钅乙Ｙ
针	钅十Ｚ
钉	钅丁Ｄ
钊	钅刂Ｚ
钋	钅卜Ｐ
钌	钅乛亅
钍	钅土Ｔ
钎	钅千Ｑ
钏	钅川Ｃ
钐	钅彡Ｓ
钒	钅几丶
钓	钅勹丶
钔	钅门Ｍ
钕	钅女Ｎ
钗	钅又丶
钙	钅一Ｓ
钚	钅不Ｂ
钛	钅大丶
钜	钅匚尸
钝	钅七凵
钞	钅少Ｃ
钟	钅口丨
钠	钅内Ｎ
钡	钅贝Ｂ
钢	钅冂乂
钣	钅反反
钤	钅亽乛
钥	钅月Ｙ
钦	钅欠Ｑ
钧	钅勹冫
钨	钅乌Ｗ
钩	钅勹厶
钪	钅亠几
钫	钅方Ｆ
钬	钅火Ｈ
钭	钅斗Ｄ
钮	钅丑Ｎ
钯	钅巴Ｂ
钰	钅王丶
钱	钅一戈
钲	钅一止
钳	钅廿一
钴	钅古Ｇ
钵	钅木一
钷	钅匚口
钹	钅犮Ｂ
钺	钅戈乚
钻	钅占占
钼	钅目Ｍ
钽	钅日一
钾	钅甲Ｊ
钿	钅田Ｄ
铀	钅由Ｙ
铁	钅失Ｔ
铂	钅白Ｂ
铃	钅亽龴
铄	钅Ｃ小
铅	钅几口
铆	钅Ｇ卩
铈	钅亠巾
铉	钅玄Ｘ
铊	钅宀匕
铋	钅心丿
铌	钅尸匕
铍	钅皮Ｐ
铎	钅又干
铐	钅耂丂
铑	钅耂匕
铒	钅耳Ｅ
铕	钅厂冃
铖	钅戊亅
铗	钅夫丷
铘	钅一阝
铙	钅戈儿
铛	钅Ｍ彐
铜	钅冂一
铝	钅口口
铞	钅口巾
铟	钅囗大
铠	钅山己
铡	钅贝刂
铢	钅朱Ｚ
铣	钅牛儿
铤	钅壬廴
铥	钅千厶
铧	钅匕十
铨	钅全Ｑ
铩	钅乂朩
铪	钅亼口
铫	钅ＫＫ
铬	钅各Ｇ
铭	钅夕口
铮	钅刀亅
铯	钅刀巴
铰	钅亠父
铱	钅衣Ｙ
铲	钅立丿
铳	钅充儿
铴	钅氵Ｊ
铵	钅安安
银	钅艮Ｙ
铷	钅女口
铸	钅丰寸
铹	钅营力
铺	钅甫Ｐ
铼	钅未丷
铽	钅弋心
链	钅车辶
铿	钅又土
销	钅Ｍ冃
锁	钅Ｍ贝
锂	钅里Ｌ
锃	钅口王
锄	钅且力
锅	钅口内
锆	钅告Ｇ
锇	钅手戈
锈	钅禾乃
锉	钅人土
锊	钅爫寸
锋	钅夂丰
锌	钅辛Ｘ
锍	钅充川
锎	钅门一
锏	钅门日
锐	钅丷儿
锑	钅丷弓
锒	钅丶艮
锓	钅彐又
锔	钅尸亅
锕	钅阝可
锖	钅青Ｑ
锗	钅者Ｚ
锘	钅艹口
错	钅龷日
锚	钅艹田
锛	钅大廾
锝	钅日寸
锞	钅日木
锟	钅日比
锡	钅日勹
锢	钅囗古
锣	钅罒夕
锤	钅千垂
锥	钅隹Ｚ
锦	钅白巾
锨	钅斤欠
锩	钅龹㔾
锪	钅勹心
锫	钅立口
锬	钅火火
锭	钅宀止
键	钅彐廴
锯	钅尸古
锰	钅子皿
锱	钅巛田
锲	钅刀大
锴	钅比白
锵	钅夕寸
锶	钅田心
锷	钅口Ｓ
锸	钅千臼
锹	钅禾火
锺	钅千里
锻	钅Ｅ殳
锼	钅叟Ｓ
锾	钅爫又
锿	钅衣口
镀	钅广又
镁	钅<美上>大
镂	钅米女
镄	钅弓贝
镅	钅尸目
镆	钅莫Ｍ
镇	钅十八
镉	钅一冂
镊	钅耳又
镌	钅隹乃
镍	钅丿木
镎	钅亼手
镏	钅刀田
镐	钅高Ｇ
镑	钅旁方
镒	钅首皿
镓	钅宀豕
镔	钅穴丘
镖	钅覀示
镗	钅尚土
镘	钅日又
镛	钅广冃
镜	钅竟Ｊ
镝	钅啇Ｄ
镞	钅族矢
镡	钅覀十
镢	钅厂欠
镣	钅大小
镤	钅业丶
镥	钅鱼日
镦	钅高攵
镧	钅门木
镨	钅首日
镩	钅穴丨
镪	钅弓虽
镫	钅癶首
镬	钅艹又
镭	钅雨田
镯	钅罒勹
镰	钅广兼
镱	钅立心
镲	钅宀示
镳	钅鹿灬
镶	钅衣口
长	长ＣＧ
长	长ＺＧ
门	门ＭＮ
闩	门一Ｓ
闪	门人Ｓ
闫	门三Ｙ
闭	门才Ｂ
问	门口Ｗ
闯	门马Ｃ
闰	门王Ｒ
闱	门二卩
闲	门木Ｘ
闳	门厂厶
间	门日Ｊ
闵	门文Ｍ
闶	门亠几
闷	门心Ｍ
闸	门甲Ｚ
闹	门亠巾
闺	门圭Ｇ
闻	门耳Ｗ
闼	门大辶
闽	门虫Ｍ
闾	门口口
阀	门亻戈
阁	门各Ｇ
阂	门亥Ｈ
阃	门囗木
阄	门刀日
阅	门丷口
阆	门丶艮
阈	门戈口
阉	门大日
阊	门日日
阋	门臼儿
阌	门受Ｗ
阍	门Ｃ七
阎	门刀臼
阏	门方人
阐	门丷日
阑	门木柬
阒	门目大
阔	门氵舌
阕	门癶一
阖	门土厶
阗	门十且
阙	门丷屮
阚	门乛耳
阜	追十Ｆ
队	阝人Ｄ
阡	阝千Ｑ
阪	阝反反
阮	阝元Ｒ
阱	阝井Ｊ
防	阝方Ｆ
阳	阝日Ｙ
阴	阝月Ｙ
阵	阝车Ｚ
阶	阝人刂
阻	阝且Ｚ
阼	阝乍Ｚ
阽	阝占占
阿	阝可Ａ
阿	阝可Ｅ
陀	阝宀匕
陂	阝皮Ｐ
附	阝亻寸
际	阝示Ｊ
陆	阝干凵
陇	阝龙Ｌ
陈	阝七小
陉	阝又工
陋	阝一乚
陌	阝丆日
降	阝夂舛
限	阝艮Ｘ
陔	阝亥Ｇ
陕	阝夫丷
陛	阝比土
陟	阝止少
陡	阝走Ｄ
院	阝宀元
除	阝余Ｃ
陧	阝日土
陨	阝口贝
险	阝亼兴
陪	阝立口
陬	阝耳又
陲	阝千垂
陴	阝卑卑
陵	阝土夂
陶	阝勹缶
陷	阝刀臼
隅	阝甲冂
隆	阝夂龶
隈	阝田ｒ
隋	阝厂冃
隍	阝白王
随	阝厂辶
隐	阝刀心
隔	阝一冂
隗	阝白儿
隘	阝首皿
隙	阝小小
障	阝章Ｚ
隧	阝首辶
隰	阝日灬
隳	阝厂小
隶	彐水Ｌ
隹	隹ＺＩ
隼	隹十Ｓ
隽	隹乃Ｊ
难	又隹Ｎ
雀	小隹Ｑ
雁	厂亻隹
雄	厂厶隹
雅	一才隹
集	隹木Ｊ
雇	户隹Ｇ
雉	矢隹Ｚ
雌	止匕隹
雍	亠丿隹
雎	且隹Ｊ
雏	刀彐隹
雒	各隹Ｌ
雕	冂土隹
雠	隹讠隹
雨	雨ＹＵ
雩	雨二Ｓ
雪	雨彐Ｘ
雯	雨文Ｗ
雳	雨厂力
零	雨亽龴
雷	雨田Ｌ
雹	雨包Ｂ
雾	雨夂力
需	雨丆皿
霁	雨文刂
霄	雨Ｍ冃
霆	雨壬廴
震	雨厂ｒ
霈	雨氵巾
霉	雨人母
霍	雨隹Ｈ
霎	雨立女
霏	雨非Ｆ
霓	雨臼儿
霖	雨林Ｌ
霜	雨木目
霞	雨丨又
霪	雨氵壬
霭	雨讠勹
霰	雨冃攵
露	雨足各
霸	雨革月
霹	雨尸辛
霾	雨豸里
青	青ＱＧ
靓	青见Ｌ
靓	青见Ｊ
靖	立青Ｊ
静	青刀亅
靛	青宀止
非	非ＦＩ
靠	告非Ｋ
靡	广林非
面	丆罒二
靥	厂大罒
革	革ＧＥ
靳	革斤Ｊ
靴	革亻匕
靶	革巴Ｂ
靼	革日一
鞅	革央Ｙ
鞋	革圭Ｘ
鞍	革安安
鞑	革大辶
鞒	革丿刂
鞔	革刀儿
鞘	革Ｍ冃
鞠	革勹米
鞣	革龴木
鞫	革勹言
鞭	革亻丈
鞯	革艹子
鞲	革井冂
鞴	革龷用
韦	二卩Ｗ
韧	二卩刀
韩	十十卩
韪	日止二
韫	二卩皿
韬	二卩臼
韭	非一Ｊ
音	立日Ｙ
韵	立日勹
韶	立日召
页	页ＹＥ
顶	丁页Ｄ
顷	匕页Ｑ
顸	干页Ｈ
项	工页Ｘ
顺	川页Ｓ
须	彡页Ｘ
顼	王页Ｘ
顽	元页Ｗ
顾	厂㔾页
顿	七凵页
颀	斤页Ｑ
颁	分页Ｂ
颂	八厶页
颃	亠几页
预	龴丁页
颅	卜尸页
领	亽龴页
颇	皮页Ｐ
颈	又工页
颉	吉页Ｘ
颉	吉页Ｊ
颊	夫丷页
颌	亼口页
颍	匕水页
颏	亥页Ｋ
颐	匚丨页
频	止少页
颓	禾几页
颔	亽口页
颖	匕禾页
颗	日木页
题	日止页
颚	口Ｓ页
颛	山皿页
颜	立丿页
额	宀各页
颞	耳又页
颟	艹两页
颠	十八页
颡	又木页
颢	日小页
颤	亠一页
颥	雨皿页
颦	止页卑
颧	艹隹页
风	风ＦＧ
飑	风包Ｂ
飒	立风Ｓ
飓	风且八
飕	风叟Ｓ
飘	覀示风
飙	大大风
飞	乙冫Ｆ
食	食ＳＩ
飧	夕食Ｓ
飨	丝丿食
餍	厂大食
餐	卜又食
餮	歹人食
饔	亠丝食
饕	口虍食
饥	饣几Ｊ
饧	饣Ｊ彳
饨	饣七凵
饩	饣气Ｘ
饪	饣壬Ｒ
饫	饣丿大
饬	饣人力
饭	饣反反
饮	饣欠Ｙ
饯	饣一戈
饰	饣人巾
饱	饣包Ｂ
饲	饣亅一
饴	饣厶口
饵	饣耳Ｅ
饶	饣戈儿
饷	饣白口
饺	饣亠父
饼	饣首廾
饽	饣十子
饿	饣手戈
馁	饣爫女
馄	饣日比
馅	饣刀臼
馆	饣宀官
馇	饣木一
馈	饣贵Ｋ
馊	饣叟Ｓ
馋	饣刀冫
馍	饣莫Ｍ
馏	饣刀田
馐	饣羊丑
馑	饣廿龶
馒	饣日又
馓	饣龷攵
馔	饣巳八
馕	饣十ｒ
首	首丿目
馗	九首丿
馘	首目戈
香	禾日Ｘ
馥	禾日夂
馨	声殳日
马	马ＭＡ
驭	马又Ｙ
驮	马大Ｔ
驮	马大Ｄ
驯	马川Ｘ
驰	马也Ｃ
驱	马匚乂
驳	马乂乂
驴	马户Ｌ
驵	马且Ｚ
驶	马口乂
驷	马囗儿
驸	马亻寸
驹	马勹口
驺	马刀彐
驻	马主Ｚ
驼	马宀匕
驽	女又马
驾	加马Ｊ
驿	马又干
骀	马厶口
骁	马戈儿
骂	口口马
骄	马丿刂
骅	马匕十
骆	马各Ｌ
骇	马亥Ｈ
骈	马首廾
骊	马一冂
骋	马由丂
验	马亼兴
骏	马厶夂
骐	马其Ｑ
骑	马大可
骒	马日木
骓	马隹Ｚ
骖	马厶彡
骗	马户冊
骘	阝止马
骚	马又虫
骛	龴攵马
骜	敖马Ａ
骝	马刀田
骞	宀井马
骟	马户羽
骠	马覀示
骡	马田小
骢	马白心
骣	马尸子
骤	马又乑
骥	马匕八
骧	马衣口
骨	骨ＧＵ
骰	骨殳Ｔ
骱	骨人刂
骶	骨Ｃ七
骷	骨古Ｋ
骸	骨亥Ｈ
骺	骨Ｆ口
骼	骨各Ｇ
髀	骨卑卑
髁	骨日木
髂	骨宀各
髅	骨米女
髋	骨宀见
髌	骨穴丘
髑	骨罒勹
髓	骨厂辶
高	高ＧＯ
髡	髟一儿
髦	髟毛Ｍ
髫	髟召Ｔ
髭	髟止匕
髯	髟冂土
髹	髟亻木
髻	髟吉Ｊ
鬃	髟宀示
鬈	髟龹㔾
鬏	髟禾火
鬓	髟穴丘
鬟	髟罒ｒ
鬣	髟巛鼠
鬯	乂凵匕
鬲	一口冂
鬻	弓弓冂
鬼	白儿厶
魁	白儿斗
魂	云白儿
魃	白儿犮
魄	白白儿
魅	白儿未
魇	厂大儿
魈	白儿Ｍ
魉	白儿两
魍	白儿冂
魏	禾女儿
魑	白儿文
魔	广林儿
鱼	鱼ＹＵ
鱿	鱼尢丶
鲁	鱼日Ｌ
鲂	鱼方Ｆ
鲅	鱼犮Ｂ
鲆	鱼干丷
鲇	鱼占占
鲈	鱼卜尸
鲋	鱼亻寸
鲍	鱼包Ｂ
鲎	学鱼Ｈ
鲐	鱼厶口
鲑	鱼圭Ｇ
鲒	鱼吉Ｊ
鲔	鱼厂冃
鲕	鱼丆皿
鲚	鱼文刂
鲛	鱼亠父
鲜	鱼羊Ｘ
鲞	龹鱼Ｘ
鲟	鱼彐寸
鲠	鱼丈日
鲡	鱼一冂
鲢	鱼车辶
鲣	鱼又土
鲤	鱼里Ｌ
鲥	鱼日寸
鲦	鱼夂朩
鲧	鱼丿小
鲨	氵少鱼
鲩	鱼宀元
鲫	鱼艮卩
鲭	鱼青Ｑ
鲮	鱼土夂
鲰	鱼耳又
鲱	鱼非Ｆ
鲲	鱼日比
鲳	鱼日日
鲴	鱼囗古
鲵	鱼臼儿
鲷	鱼冂土
鲸	鱼高小
鲺	鱼乙丿
鲻	鱼巛田
鲼	鱼十贝
鲽	鱼世木
鳃	鱼田心
鳄	鱼口Ｓ
鳅	鱼禾火
鳇	鱼白王
鳊	鱼户冊
鳌	敖鱼Ａ
鳍	鱼耂日
鳎	鱼日羽
鳏	鱼罒冫
鳐	鱼爫缶
鳓	鱼革力
鳔	鱼覀示
鳕	鱼雨彐
鳖	丷攵鱼
鳗	鱼日又
鳘	人攵鱼
鳙	鱼广冃
鳜	鱼厂欠
鳝	鱼羊口
鳞	鱼米舛
鳟	鱼酋寸
鳢	鱼日首
鸟	鸟ＮＯ
鸠	九鸟Ｊ
鸡	又鸟Ｊ
鸢	弋鸟Ｙ
鸣	口鸟Ｍ
鸥	匚乂鸟
鸦	一才鸟
鸨	匕十鸟
鸩	巾乚鸟
鸪	古鸟Ｇ
鸫	七小鸟
鸬	卜尸鸟
鸭	甲鸟Ｙ
鸯	央鸟Ｙ
鸱	Ｃ七鸟
鸲	勹口鸟
鸳	夕㔾鸟
鸵	鸟宀匕
鸶	丝丝鸟
鸷	执执鸟
鸸	丆皿鸟
鸹	舌鸟Ｇ
鸺	亻木鸟
鸽	亼口鸟
鸾	亦鸟Ｌ
鸿	氵工鸟
鹁	十子鸟
鹂	一冂鸟
鹃	口冃鸟
鹄	告鸟Ｈ
鹄	告鸟Ｇ
鹅	手戈鸟
鹆	谷鸟Ｙ
鹇	门木鸟
鹈	丷丿鸟
鹉	一止鸟
鹊	龷日鸟
鹋	艹田鸟
鹌	大乚鸟
鹎	卑卑鸟
鹏	月月鸟
鹑	高子鸟
鹕	古月鸟
鹗	口Ｓ鸟
鹘	骨鸟Ｈ
鹘	骨鸟Ｇ
鹚	首幺鸟
鹛	尸目鸟
鹜	龴攵鸟
鹞	爫缶鸟
鹣	首兼鸟
鹤	冖隹鸟
鹦	贝女鸟
鹧	广廿鸟
鹨	羽彡鸟
鹩	大小鸟
鹪	焦鸟Ｊ
鹫	高丶鸟
鹬	龴冂鸟
鹭	足各鸟
鹰	广亻鸟
鹱	鸟艹又
鹳	艹隹鸟
鹾	卜囗工
鹿	鹿比Ｌ
麂	鹿比几
麇	鹿比禾
麈	鹿比主
麋	鹿比米
麒	鹿比其
麓	林鹿比
麝	鹿比寸
麟	鹿米舛
麦	龶夂Ｍ
麸	龶夂夫
麻	广林Ｍ
麽	广林厶
麾	广林毛
黄	龷由八
黉	学龷八
黍	禾人氺
黎	禾勹氺
黏	禾氺占
黑	黑ＨＩ
黔	黑亽乛
默	黑大丶
黛	代黑Ｄ
黜	黑出Ｃ
黝	黑幺力
黟	黑夕夕
黠	黑吉Ｘ
黢	黑厶夂
黥	黑高小
黧	禾勹黑
黩	黑十头
黪	黑厶彡
黯	黑立日
黹	业丷巾
黻	业巾犮
黼	业巾甫
黾	口日乚
鼋	元口乚
鼍	口口乚
鼎	目爿片
鼐	乃爿片
鼓	吉首又
鼗	Ｋ首又
鼙	吉十卑
鼠	臼鼠Ｓ
鼢	臼鼠分
鼬	臼鼠由
鼯	臼鼠口
鼷	臼鼠大
鼹	臼鼠安
鼻	丿目丌
鼽	丿丌九
鼾	丿丌干
齐	文刂Ｑ
齑	文非刂
齿	止人凵
龀	止凵匕
龃	止凵且
龄	止凵龴
龅	止凵包
龆	止凵召
龇	止凵匕
龈	止凵艮
龉	止凵口
龊	止凵足
龋	止凵冂
龌	止凵土
龙	龙ＬＧ
龚	龙龷八
龛	亼口龙
龟	刀日乚
龠	亼口冊
丌	丌？？
丨	丨？？
丬	丬？？
丶	丶？？
丿	丿？？
乇	丿七？
亠	亠？？
亻	亻？？
佧	亻卜下
冂	冂？？
冖	冖？？
冫	冫？？
凵	凵？？
刂	刂？？
勹	勹？？
匚	匚？？
卩	卩？？
厶	厶？？
咭	口吉？
哜	口文刂
囗	囗？？
囝	囗子？
坶	土母？
垅	土龙？
堀	土尸出
夂	夂？？
嬲	田力力
宀	宀？？
屮	屮？？
巛	巛？？
庀	广匕？
廴	廴？？
廾	廾？？
弪	弓又工
彐	彐？？
彡	彡？？
後	彳幺夂
忄	忄？？
憝	高攵心
扌	扌？？
拚	扌厶廾
挢	扌丿刂
捱	扌厂圭
揎	扌宀一
揞	扌立日
揲	扌世木
搿	龵亼手
摺	扌羽白
擗	扌尸辛
攴	卜又？
攵	攵？？
朊	月元？
楱	木<春上>大
榀	木口口
榘	矢匚木
欷	乂厂欠
氵	氵？？
氽	人水？
沲	氵人也
泶	学水？
渖	氵宀丨
灬	灬？？
熳	火日又
犭	犭？？
猓	犭日木
猸	犭尸目
甙	弋廿一
疋	乛止？
疒	疒？？
痖	疒亚？
矽	石夕？
砦	止匕石
砩	石弓刂
硷	石亼兴
磺	石龷八
礤	石艹示
礻	礻？？
窆	穴丿之
箝	竹扌廿
簦	竹癶首
糸	幺小？
纟	纟？？
缋	纟贵？
缍	纟千垂
缏	纟亻丈
肀	彐丨？
肜	月彡？
膣	月穴土
膪	月旁口
臁	月广兼
舡	舟工？
舨	舟反反
艹	艹？？
茇	艹犮？
菸	艹方冫
虍	虍？？
蚵	虫可？
螓	虫<春上>禾
蟓	虫象？
蠛	虫艹戊
衤	衤？？
謦	声殳言
讠	讠？？
诶	讠厶矢
谘	讠欠口
跫	工几足
軎	車口？
辶	辶？？
醣	酉广口
钅	钅？？
钶	钅可？
钸	钅厂巾
镙	钅田小
镟	钅族止
阝	阝？？
阢	阝一儿
飚	风火火
饣	饣？？
馀	饣余？
髟	髟？？
鲶	鱼亽心
鳆	鱼人夂
鳋	鱼又虫
麴	木夂勹
齄	丿丌一